30 100
TGGCTTAGTAAAGTCCTAGCACCGCCGCAA|GGTGCCCTCTCATGTCTTCACGCGAAGGCA
GCCGTGATGTCTTCACGCGAAGGCATACGC|GACTTAGCGCCGAAAACTATCATGTCTTCA
GCCGAAAACTATCATGTCTTCACGCGAAGG|TCCCGACTGGCGTTACTAGGTTATTCATGT
GGTTGAAACGTCATGTCTTCACGCGAAGGC|CGACCATTGCCAATATGGACGAAAAAAGTC
GTGATGTCTTCACGCGAAGGCATACGCCGT|TTAGCGCCGAAAACTATCATGTCTTCACGC
GGGTGTAGATGCTAAAAATCTGGGTAGTTA|GGTTTTGGAGGCCTCTCGTCCAATTTCACA
TCTTCACGCGAAGGCATACGCCGTGATGTC|CCGCTTGAACCATCGATGGGACTTAGCGCC
CTTTGCTCTCGCACAACGCGGGCTCGCCCG|GCATGTCTTCACGCGAAGGCATACGCCGTG
GGGAGCGTTATCCTAGGGCTTTGCTCTCGC|CGCGAAGGCATACGCCGTGCATGTCTTCAC
CACGCGAAGGCATACGCCGTGATTCGGTCT|GGCATACGCCGTGCCTGGATTATCATGTCT
ACCGACCATTGCCAATATGGACGAAAAAAG|ATAACCTTGTCACGTCCGGGAGCGTTATCC
ACGCCGTGCGTGTGCTTTTATACCGCTTGA|ACGGTGCCATTGAGAGCGATCACACGGGGA
TCACGCGAAGGCATACGCCGTGATGTCTTC|CTTGAACCATCGATGGGACTTAGCGCCGAA
GAGGCCTCTCGTCCAATTTCACAACCGGTG|CCTGTCATGTCTTCACGCGAAGGCATACGC
TCATGTCTTCACGCGAAGGCATACGCCGTG|TACGCCGTGATGTCTTCACGCGAAGGCATA
CATACGCCGTGATTCGGTCTCACGGTGATC|GTGCCTGGATTATCATGTCTTCACGCGAAG
CCGACCATTGCCAATATGGACGAAAAAAGT|TAACCTTGTCACGTCCGGGAGCGTTATCCT
GCCAATATGGACGAAAAAAGTCACTTATCA|CACGTCCGGGAGCGTTATCCTAGGGCTTTG
ATTTCAAACTTAGTTTCGTTCGGGTGTAGA|CGCGAAGGCATACGCCGTGGTGGTTTTGGA
TCTCACGGTGATCCTAGAAGGCCTGTTCAA|TCTTCACGCGAAGGCATACGCCGTGTTGAC
ACGAAAAAAGTCACTTATCAGTATGCGCGT|AGCGTTATCCTAGGGCTTTGCTCTCGCACA
AAGCTGGCTTAGTAAAGTCCTAGCACCGCC|ACCGGGTGCCCTCTCATGTCTTCACGCGAA
ACGCGAAGGCATACGCCGTGTTCATACCTT|GGACGCTCGTCCACTCCGTCATGTAAAATC
CTCCGTCATGTAAAATCCGAGTGTCAACGG|TATCCGCTAGACTGCCTGTGGGACCTGCTC
CACGCGAAGGCATACGCCGTGCATGTCTTC|TGGCGAACGGACGATGTTACGCATGAGCGA
CACGCGAAGGCATACGCCGTGGCGAACGGA|TTATTCATGTCATGTCTTCACGCGAAGGCA
ACTCACTATTGGCACAAAGTTCCTTTTCGA|TGCCTGAAGGCTTGTATACTAATACTGGGA
TGCCTGGATTATCATGTCTTCACGCGAAGG|GCGGAGTCCCTGTGATGCCCGAGAGAAACG
GAAGGCATACGCCGTGATTCGGTCTCACGG|ACGCCGTGCCTGGATTATCATGTCTTCACG
CGGTGCCATTGAGAGCGATCACACGGGGAT|TGATTCGGTCTCACGGTGATCCTAGAAGGC
GTGCCTGTCATGTCTTCACGCGAAGGCATA|CAACGCGGGCTCGCCCGTAGTATTTCTCAT
TCACGCGAAGGCATACGCCGTGAGATTATA|GATGTCTTCACGCGAAGGCATACGCCGTGC
CCCCAGGCTAGGCGTGGACGCTCGTCCACT|GTCCGGCTGCGTGGTCCATTCTAAATGCTA
CTTGTCACGTCCGGGAGCGTTATCCTAGGG|TTCATGTCTTCACGCGAAGGCATACGCCGT
GGCATACGCCGTGGCGAACGGACGATGTTA|GTCATGTCTTCACGCGAAGGCATACGCCGT
TGAACTTGCAAGGGGGGGCCTCACGTTGTC|CAAAGTTCCTTTTCGATGCCCCATCCCCTA
GCCGTGTTGACCGGGTGCCCTCTCATGTCT|GACGGTGAACTTGCAAGGGGGGGCCTCACG
TTGCGCCCAAGATTAGGGTTGAAACGTCAT|GGCATACGCCGTGCACCGACCATTGCCAAT
TAGGCGTGGACGCTCGTCCACTCCGTCATG|GCGTGGTCCATTCTAAATGCTATCCGCTAG
CGCCGTGCCGTTCATGTCTTCACGCGAAGG|TCACGCGAAGGCATACGCCGTGGCGAACGG
TTAGGCTCACCCCAGGACTCACTATTGGCA|CATGTGAACTAGGCACTGCCTGAAGGCTTG
CGAAGGCATACGCCGTGTTCATACCTTACC|CGCTCGTCCACTCCGTCATGTAAAATCCGA
CGCGAAGGCATACGCCGTGGTGGTTTTGGA|AAAAAAGTCACTTATCAGTATGCGCGTGCC
GCATACGCCGTGATTCGGTCTCACGGTGAT|CGTGCCTGGATTATCATGTCTTCACGCGAA
TCAACGGTTAGGCTCACCCCAGGACTCACT|CCTGCTCCATGTGAACTAGGCACTGCCTGA
ATGTCTTCACGCGAAGGCATACGCCGTGGT|ATATGGACGAAAAAAGTCACTTATCAGTAT
AGGCATACGCCGTGCCGTTCATGTCTTCAC|CATGTCTTCACGCGAAGGCATACGCCGTGG
TCACTTATCAGTATGCGCGTGCCTGTCATG|TAGGGCTTTGCTCTCGCACAACGCGGGCTC
TTCGGGTGTAGATGCTAAAAATCTGGGTAG|GGTGGTTTTGGAGGCCTCTCGTCCAATTTC
ACGCGAAGGCATACGCCGTGTCATGTCTTC|GTCTGCCAGTAGCGCCCCCAGGCTAGGCGT
TTGCAAGGGGGGGCCTCACGTTGTCTGCCA|TTCCTTTTCGATGCCCCATCCCCTACTATC
CTTCACGCGAAGGCATACGCCGTGCCGTTC|CGAAAACTATCATGTCTTCACGCGAAGGCA
TGTCTTCACGCGAAGGCATACGCCGTGCGT|TGAGCGATCAAGGGCCTATACGGTGCCATT
TCACAAATTTCAAACTTAGTTTCGTTCGGG|TCTTCACGCGAAGGCATACGCCGTGGTGGT
CAGTAGCGCCCCCAGGCTAGGCGTGGACGC|TCACAGGTGGTCCGGCTGCGTGGTCCATTC
CCTATACGGTGCCATTGAGAGCGATCACAC|ACGCCGTGATTCGGTCTCACGGTGATCCTA
AAGGGCCTATACGGTGCCATTGAGAGCGAT|GGCATACGCCGTGATTCGGTCTCACGGTGA
AACCGGTGCCAATTGACTCTAGTTCCTCAT|GCATACGCCGTGGACGATCGAGTCATGTCT
AATTTTCCCTAAACTATTGGCCTTGCGCCC|GTTCCTCATGTCTTCACGCGAAGGCATACG
CGCCGCAAGCTGGTGTTCAACACCACGCTG|CGAAGGCATACGCCGTGTCATGTCTTCACG
ATCGAGTCATGTCTTCACGCGAAGGCATAC|AAGGCATACGCCGTGATGTCTTCACGCGAA
GGCATACGCCGTGTCATGTCTTCACGCGAA|AGTAGCGCCCCCAGGCTAGGCGTGGACGCT
GTTGAAACGTCATGTCTTCACGCGAAGGCA|GACCATTGCCAATATGGACGAAAAAAGTCA
TGGCGAACGGACGATGTTACGCATGAGCGA|ACGCGAAGGCATACGCCGTGTCTTCACGCG
TTCACGCGAAGGCATACGCCGTGAGATTAT|TGATGTCTTCACGCGAAGGCATACGCCGTG
TAGGCTCACCCCAGGACTCACTATTGGCAC|ATGTGAACTAGGCACTGCCTGAAGGCTTGT
CATACGCCGTGTCTTCACGCGAAGGCATAC|ATGTCTTCACGCGAAGGCATACGCCGTGCC
GTCATGTCTTCACGCGAAGGCATACGCCGT|GGGCTCGCCCGTAGTATTTCTCATGTCTTC
ACGCGAAGGCATACGCCGTGGTGGTTTTGG|GAAAAAAGTCACTTATCAGTATGCGCGTGC
GGTTTTGGAGGCCTCTCGTCCAATTTCACA|GCGCGTGCCTGTCATGTCTTCACGCGAAGG
TATCATGTCTTCACGCGAAGGCATACGCCG|GCGTTACTAGGTTATTCATGTCATGTCTTC
GAAGGCATACGCCGTGTCTTCACGCGAAGG|GGCTCATGTCTTCACGCGAAGGCATACGCC
GCGAAGGCATACGCCGTGTCTTCACGCGAA|CTGGCTCATGTCTTCACGCGAAGGCATACG
GGCATACGCCGTGCCTGGATTATCATGTCT|CATACCTTACCGCGGAGTCCCTGTGATGCC
TTGTACCAATTTTCCCTAAACTATTGGCCT|GACTCTAGTTCCTCATGTCTTCACGCGAAG
TACGCCGTGTCTTCACGCGAAGGCATACGC|GTCTTCACGCGAAGGCATACGCCGTGCCTG
GCCTCTCGTCCAATTTCACAACCGGTGCCA|GTCATGTCTTCACGCGAAGGCATACGCCGT
CATGTCTTCACGCGAAGGCATACGCCGTGT|TCAACACCACGCTGGCTCATGTCTTCACGC
TCACGTCCGGGAGCGTTATCCTAGGGCTTT|TGTCTTCACGCGAAGGCATACGCCGTGCAT
CGCGTATGACGGTGAACTTGCAAGGGGGGG|TCACTATTGGCACAAAGTTCCTTTTCGATG
GCGAAGGCATACGCCGTGGCGAACGGACGA|TTCATGTCATGTCTTCACGCGAAGGCATAC
CCGAGTGTCAACGGTTAGGCTCACCCCAGG|TGTGGGACCTGCTCCATGTGAACTAGGCAC
GTCTTCACGCGAAGGCATACGCCGTGCATG|CGCCGTGGCGAACGGACGATGTTACGCATG
GCGAAGGCATACGCCGTGCGTGTGCTTTTA|AAGGGCCTATACGGTGCCATTGAGAGCGAT
CGCCGTGTCTTCACGCGAAGGCATACGCCG|CTTCACGCGAAGGCATACGCCGTGCCTGGA
TACCTTACCGCGGAGTCCCTGTGATGCCCG|AAAATCCGAGTGTCAACGGTTAGGCTCACC
TCCCTGTGATGCCCGAGAGAAACGCGTATG|ACGGTTAGGCTCACCCCAGGACTCACTATT
GGGCCTATACGGTGCCATTGAGAGCGATCA|CATACGCCGTGATTCGGTCTCACGGTGATC
GCACCGACCATTGCCAATATGGACGAAAAA|TTATAACCTTGTCACGTCCGGGAGCGTTAT
CGAAGGCATACGCCGTGGCGAACGGACGAT|TCATGTCATGTCTTCACGCGAAGGCATACG
GGGCTTTGCTCTCGCACAACGCGGGCTCGC|CGTGCATGTCTTCACGCGAAGGCATACGCC
ACGGGGATAAGTCCCTAGGAGACGAGTCCC|TAGAAGGCCTGTTCAAGCTGGCTTAGTAAA
CGCCGTGGCGAACGGACGATGTTACGCATG|TCTTCACGCGAAGGCATACGCCGTGTCTTC
TCTTCACGCGAAGGCATACGCCGTGAGATT|CGTGATGTCTTCACGCGAAGGCATACGCCG
ATACGGTGCCATTGAGAGCGATCACACGGG|CCGTGATTCGGTCTCACGGTGATCCTAGAA
CGCGAAGGCATACGCCGTGGCGAACGGACG|ATTCATGTCATGTCTTCACGCGAAGGCATA
GCTCACCCCAGGACTCACTATTGGCACAAA|TGAACTAGGCACTGCCTGAAGGCTTGTATA
TCACCCCAGGACTCACTATTGGCACAAAGT|AACTAGGCACTGCCTGAAGGCTTGTATACT
GATGTCTTCACGCGAAGGCATACGCCGTGC|AGCGCCGAAAACTATCATGTCTTCACGCGA
GAGTCATGTCTTCACGCGAAGGCATACGCC|GCATACGCCGTGATGTCTTCACGCGAAGGC
GAAATTTGTACCAATTTTCCCTAAACTATT|CAATTGACTCTAGTTCCTCATGTCTTCACG
CGAAGGCATACGCCGTGTCTTCACGCGAAG|TGGCTCATGTCTTCACGCGAAGGCATACGC
ACAACCGGTGCCAATTGACTCTAGTTCCTC|AGGCATACGCCGTGGACGATCGAGTCATGT
CCTACTATCACAGGTGGTCCGGCTGCGTGG|ATATGAGTATGAGGGTATAAGTAACAAGCC
CTCTAGTTCCTCATGTCTTCACGCGAAGGC|ATCGAGTCATGTCTTCACGCGAAGGCATAC
CCTAGGGCTTTGCTCTCGCACAACGCGGGC|ACGCCGTGCATGTCTTCACGCGAAGGCATA
TGTCTTCACGCGAAGGCATACGCCGTGATT|CGCGAAGGCATACGCCGTGCCTGGATTATC
CACAGGTGGTCCGGCTGCGTGGTCCATTCT|ATGAGGGTATAAGTAACAAGCCCGGGAAAA
CTGGCTCATGTCTTCACGCGAAGGCATACG|ACGCGAAGGCATACGCCGTGTTCATACCTT
CGAAGGCATACGCCGTGGACGATCGAGTCA|TATTTCTCATGTCTTCACGCGAAGGCATAC
CTTGCAAGGGGGGGCCTCACGTTGTCTGCC|GTTCCTTTTCGATGCCCCATCCCCTACTAT
AACGCGGGCTCGCCCGTAGTATTTCTCATG|GAAGGCATACGCCGTGCGTGTGCTTTTATA
CGTGGCGAACGGACGATGTTACGCATGAGC|TCACGCGAAGGCATACGCCGTGTCTTCACG
AGAAATTTGTACCAATTTTCCCTAAACTAT|CCAATTGACTCTAGTTCCTCATGTCTTCAC
GCGAAGGCATACGCCGTGCATGTCTTCACG|CGAACGGACGATGTTACGCATGAGCGATCA
TGGTGTTCAACACCACGCTGGCTCATGTCT|CGCCGTGTCATGTCTTCACGCGAAGGCATA
AAACTCACAAATTTCAAACTTAGTTTCGTT|CATGTCTTCACGCGAAGGCATACGCCGTGG
TCCGGGAGCGTTATCCTAGGGCTTTGCTCT|TCACGCGAAGGCATACGCCGTGCATGTCTT
AAGGCATACGCCGTGTCTTCACGCGAAGGC|GCTCATGTCTTCACGCGAAGGCATACGCCG
CATGTCTTCACGCGAAGGCATACGCCGTGC|TCTTCACGCGAAGGCATACGCCGTGAGATT
TGCGTGTGCTTTTATACCGCTTGAACCATC|CCATTGAGAGCGATCACACGGGGATAAGTC
AGGGGGGGCCTCACGTTGTCTGCCAGTAGC|TTTCGATGCCCCATCCCCTACTATCACAGG
GCGTTACTAGGTTATTCATGTCATGTCTTC|AGCACCGCCGCAAGCTGGTGTTCAACACCA
CGATCACACGGGGATAAGTCCCTAGGAGAC|GTGATCCTAGAAGGCCTGTTCAAGCTGGCT
CACCGACCATTGCCAATATGGACGAAAAAA|TATAACCTTGTCACGTCCGGGAGCGTTATC
TGATTCGGTCTCACGGTGATCCTAGAAGGC|TTATCATGTCTTCACGCGAAGGCATACGCC
TTTAAGAAATTTGTACCAATTTTCCCTAAA|GGTGCCAATTGACTCTAGTTCCTCATGTCT
GCCAATTGACTCTAGTTCCTCATGTCTTCA|CCGTGGACGATCGAGTCATGTCTTCACGCG
TCATGTCTTCACGCGAAGGCATACGCCGTG|GTGATGCCCGAGAGAAACGCGTATGACGGT
TAAGTCCCTAGGAGACGAGTCCCGACTGGC|CCTGTTCAAGCTGGCTTAGTAAAGTCCTAG
CGATCGAGTCATGTCTTCACGCGAAGGCAT|CGAAGGCATACGCCGTGATGTCTTCACGCG
TGTTCAAGCTGGCTTAGTAAAGTCCTAGCA|TGTTGACCGGGTGCCCTCTCATGTCTTCAC
GTTAGGCTCACCCCAGGACTCACTATTGGC|CCATGTGAACTAGGCACTGCCTGAAGGCTT
TATGCGCGTGCCTGTCATGTCTTCACGCGA|TCTCGCACAACGCGGGCTCGCCCGTAGTAT
TCAGTATGCGCGTGCCTGTCATGTCTTCAC|TTGCTCTCGCACAACGCGGGCTCGCCCGTA
CTTGCGCCCAAGATTAGGGTTGAAACGTCA|AGGCATACGCCGTGCACCGACCATTGCCAA
TGCCTGTCATGTCTTCACGCGAAGGCATAC|AACGCGGGCTCGCCCGTAGTATTTCTCATG
GGCATACGCCGTGCACCGACCATTGCCAAT|TACGCCGTGAGATTATAACCTTGTCACGTC
ACGGTGATCCTAGAAGGCCTGTTCAAGCTG|CACGCGAAGGCATACGCCGTGTTGACCGGG
CCAATTTTCCCTAAACTATTGGCCTTGCGC|TAGTTCCTCATGTCTTCACGCGAAGGCATA
CCTCATGTCTTCACGCGAAGGCATACGCCG|ATGTCTTCACGCGAAGGCATACGCCGTGAG
TGACCGGGTGCCCTCTCATGTCTTCACGCG|AACTTGCAAGGGGGGGCCTCACGTTGTCTG
TCTTCACGCGAAGGCATACGCCGTGCATGT|GCCGTGGCGAACGGACGATGTTACGCATGA
AGGCATACGCCGTGTTGACCGGGTGCCCTC|ACGCGTATGACGGTGAACTTGCAAGGGGGG
CATGTCTTCACGCGAAGGCATACGCCGTGC|AGGCATACGCCGTGTTCATACCTTACCGCG
ATGTTACGCATGAGCGATCAAGGGCCTATA|CGCCGTGTCTTCACGCGAAGGCATACGCCG
TGCAAGGGGGGGCCTCACGTTGTCTGCCAG|TCCTTTTCGATGCCCCATCCCCTACTATCA
GACTTAGCGCCGAAAACTATCATGTCTTCA|GAGACGAGTCCCGACTGGCGTTACTAGGTT
ACGCCGTGGTGGTTTTGGAGGCCTCTCGTC|TTATCAGTATGCGCGTGCCTGTCATGTCTT
ATGCGCGTGCCTGTCATGTCTTCACGCGAA|CTCGCACAACGCGGGCTCGCCCGTAGTATT
ACCGCTTGAACCATCGATGGGACTTAGCGC|ACACGGGGATAAGTCCCTAGGAGACGAGTC
CCTAGAAGGCCTGTTCAAGCTGGCTTAGTA|GGCATACGCCGTGTTGACCGGGTGCCCTCT
CTTCACGCGAAGGCATACGCCGTGTTGACC|CCCGAGAGAAACGCGTATGACGGTGAACTT
CACGTCCGGGAGCGTTATCCTAGGGCTTTG|GTCTTCACGCGAAGGCATACGCCGTGCATG
TGTTGACCGGGTGCCCTCTCATGTCTTCAC|GTGAACTTGCAAGGGGGGGCCTCACGTTGT
CATGTCTTCACGCGAAGGCATACGCCGTGA|TATACCGCTTGAACCATCGATGGGACTTAG
GTAGTATTTCTCATGTCTTCACGCGAAGGC|GCGTGTGCTTTTATACCGCTTGAACCATCG
TGGTTTTGGAGGCCTCTCGTCCAATTTCAC|TGCGCGTGCCTGTCATGTCTTCACGCGAAG
ATCACAGGTGGTCCGGCTGCGTGGTCCATT|GTATGAGGGTATAAGTAACAAGCCCGGGAA
ACCGGTGCCAATTGACTCTAGTTCCTCATG|CATACGCCGTGGACGATCGAGTCATGTCTT
CGGTCTCACGGTGATCCTAGAAGGCCTGTT|ATGTCTTCACGCGAAGGCATACGCCGTGTT
GGCGTGGACGCTCGTCCACTCCGTCATGTA|GTGGTCCATTCTAAATGCTATCCGCTAGAC
GACTCACTATTGGCACAAAGTTCCTTTTCG|CTGCCTGAAGGCTTGTATACTAATACTGGG
CGTGCGTGTGCTTTTATACCGCTTGAACCA|TGCCATTGAGAGCGATCACACGGGGATAAG
CATCCCCTACTATCACAGGTGGTCCGGCTG|CAAGGATATGAGTATGAGGGTATAAGTAAC
CACAAATTTCAAACTTAGTTTCGTTCGGGT|CTTCACGCGAAGGCATACGCCGTGGTGGTT
ATCAGTATGCGCGTGCCTGTCATGTCTTCA|TTTGCTCTCGCACAACGCGGGCTCGCCCGT
GCAAGGGGGGGCCTCACGTTGTCTGCCAGT|CCTTTTCGATGCCCCATCCCCTACTATCAC
GCATACGCCGTGAGATTATAACCTTGTCAC|CGCGAAGGCATACGCCGTGCCGTTCATGTC
GTATGACGGTGAACTTGCAAGGGGGGGCCT|CTATTGGCACAAAGTTCCTTTTCGATGCCC
AGAGCGATCACACGGGGATAAGTCCCTAGG|CACGGTGATCCTAGAAGGCCTGTTCAAGCT
AAACTATCATGTCTTCACGCGAAGGCATAC|ACTGGCGTTACTAGGTTATTCATGTCATGT
GTGGTCCGGCTGCGTGGTCCATTCTAAATG|GGTATAAGTAACAAGCCCGGGAAAACGGCA
CGAAGGCATACGCCGTGCCGTTCATGTCTT|TATCATGTCTTCACGCGAAGGCATACGCCG
TATTCATGTCATGTCTTCACGCGAAGGCAT|AGCTGGTGTTCAACACCACGCTGGCTCATG
TCATGTCTTCACGCGAAGGCATACGCCGTG|TTATACCGCTTGAACCATCGATGGGACTTA
TGCCATTGAGAGCGATCACACGGGGATAAG|TTCGGTCTCACGGTGATCCTAGAAGGCCTG
CGGGCTCGCCCGTAGTATTTCTCATGTCTT|GCATACGCCGTGCGTGTGCTTTTATACCGC
GATGCTAAAAATCTGGGTAGTTAGCTTTTA|GAGGCCTCTCGTCCAATTTCACAACCGGTG
TACCGCGGAGTCCCTGTGATGCCCGAGAGA|CCGAGTGTCAACGGTTAGGCTCACCCCAGG
TTTTCCCTAAACTATTGGCCTTGCGCCCAA|TCCTCATGTCTTCACGCGAAGGCATACGCC
CACGCTGGCTCATGTCTTCACGCGAAGGCA|CTTCACGCGAAGGCATACGCCGTGTTCATA
CTCGTCCAATTTCACAACCGGTGCCAATTG|TGTCTTCACGCGAAGGCATACGCCGTGGAC
CGTGGACGCTCGTCCACTCCGTCATGTAAA|GGTCCATTCTAAATGCTATCCGCTAGACTG
GTTCATGTCTTCACGCGAAGGCATACGCCG|GGCATACGCCGTGGCGAACGGACGATGTTA
ACAAAGTTCCTTTTCGATGCCCCATCCCCT|GTATACTAATACTGGGACGCCTCAAGGATA
CACACGGGGATAAGTCCCTAGGAGACGAGT|TCCTAGAAGGCCTGTTCAAGCTGGCTTAGT
GGCATACGCCGTGCGTGTGCTTTTATACCG|CCTATACGGTGCCATTGAGAGCGATCACAC
GTTCATACCTTACCGCGGAGTCCCTGTGAT|CATGTAAAATCCGAGTGTCAACGGTTAGGC
GCTCTCGCACAACGCGGGCTCGCCCGTAGT|GTCTTCACGCGAAGGCATACGCCGTGCGTG
GCGCCCCCAGGCTAGGCGTGGACGCTCGTC|GGTGGTCCGGCTGCGTGGTCCATTCTAAAT
TAGTTTCGTTCGGGTGTAGATGCTAAAAAT|TACGCCGTGGTGGTTTTGGAGGCCTCTCGT
CACCACGCTGGCTCATGTCTTCACGCGAAG|TGTCTTCACGCGAAGGCATACGCCGTGTTC
GAAGGCCTGTTCAAGCTGGCTTAGTAAAGT|TACGCCGTGTTGACCGGGTGCCCTCTCATG
ACTTAGTTTCGTTCGGGTGTAGATGCTAAA|GCATACGCCGTGGTGGTTTTGGAGGCCTCT
GTAGATGCTAAAAATCTGGGTAGTTAGCTT|TTGGAGGCCTCTCGTCCAATTTCACAACCG
TGGACGATCGAGTCATGTCTTCACGCGAAG|CACGCGAAGGCATACGCCGTGATGTCTTCA
AGGCATACGCCGTGCGTGTGCTTTTATACC|GCCTATACGGTGCCATTGAGAGCGATCACA
GAAGGCATACGCCGTGGTGGTTTTGGAGGC|AAAGTCACTTATCAGTATGCGCGTGCCTGT
CGAAGGCATACGCCGTGCCTGGATTATCAT|TGTTCATACCTTACCGCGGAGTCCCTGTGA
CTCATGTCTTCACGCGAAGGCATACGCCGT|TGTCTTCACGCGAAGGCATACGCCGTGAGA
TCTCGCACAACGCGGGCTCGCCCGTAGTAT|CTTCACGCGAAGGCATACGCCGTGCGTGTG
TGGCACAAAGTTCCTTTTCGATGCCCCATC|GCTTGTATACTAATACTGGGACGCCTCAAG
TATTGGCCTTGCGCCCAAGATTAGGGTTGA|CACGCGAAGGCATACGCCGTGCACCGACCA
GTGCCCTCTCATGTCTTCACGCGAAGGCAT|AAGGGGGGGCCTCACGTTGTCTGCCAGTAG
CTTTTATACCGCTTGAACCATCGATGGGAC|AGCGATCACACGGGGATAAGTCCCTAGGAG
GTGGACGATCGAGTCATGTCTTCACGCGAA|TCACGCGAAGGCATACGCCGTGATGTCTTC
CGAAAAAAGTCACTTATCAGTATGCGCGTG|GCGTTATCCTAGGGCTTTGCTCTCGCACAA
GCCGTGTCATGTCTTCACGCGAAGGCATAC|CCCCCAGGCTAGGCGTGGACGCTCGTCCAC
CAGGACTCACTATTGGCACAAAGTTCCTTT|GCACTGCCTGAAGGCTTGTATACTAATACT
GTGCCATTGAGAGCGATCACACGGGGATAA|ATTCGGTCTCACGGTGATCCTAGAAGGCCT
TGCCAATATGGACGAAAAAAGTCACTTATC|TCACGTCCGGGAGCGTTATCCTAGGGCTTT
GCGATCACACGGGGATAAGTCCCTAGGAGA|GGTGATCCTAGAAGGCCTGTTCAAGCTGGC
TGCCGTTCATGTCTTCACGCGAAGGCATAC|CGAAGGCATACGCCGTGGCGAACGGACGAT
GATAAGTCCCTAGGAGACGAGTCCCGACTG|GGCCTGTTCAAGCTGGCTTAGTAAAGTCCT
CTTCACGCGAAGGCATACGCCGTGATGTCT|CGCTTGAACCATCGATGGGACTTAGCGCCG
GTCTTCACGCGAAGGCATACGCCGTGTCTT|ACACCACGCTGGCTCATGTCTTCACGCGAA
GGCTAGGCGTGGACGCTCGTCCACTCCGTC|GCTGCGTGGTCCATTCTAAATGCTATCCGC
CACGCGAAGGCATACGCCGTGTTCATACCT|TGGACGCTCGTCCACTCCGTCATGTAAAAT
GTATTTCTCATGTCTTCACGCGAAGGCATA|TGTGCTTTTATACCGCTTGAACCATCGATG
TGGACGCTCGTCCACTCCGTCATGTAAAAT|TCCATTCTAAATGCTATCCGCTAGACTGCC
ATATGGACGAAAAAAGTCACTTATCAGTAT|TCCGGGAGCGTTATCCTAGGGCTTTGCTCT
TGGACGAAAAAAGTCACTTATCAGTATGCG|GGGAGCGTTATCCTAGGGCTTTGCTCTCGC
CATACGCCGTGCCGTTCATGTCTTCACGCG|GTCTTCACGCGAAGGCATACGCCGTGGCGA
AAATCCGAGTGTCAACGGTTAGGCTCACCC|TGCCTGTGGGACCTGCTCCATGTGAACTAG
CCATCGATGGGACTTAGCGCCGAAAACTAT|AAGTCCCTAGGAGACGAGTCCCGACTGGCG
TCTCATGTCTTCACGCGAAGGCATACGCCG|GGGCCTCACGTTGTCTGCCAGTAGCGCCCC
ATGTCTTCACGCGAAGGCATACGCCGTGTT|GATGCCCGAGAGAAACGCGTATGACGGTGA
CCGTTCATGTCTTCACGCGAAGGCATACGC|AAGGCATACGCCGTGGCGAACGGACGATGT
CCCAGGACTCACTATTGGCACAAAGTTCCT|AGGCACTGCCTGAAGGCTTGTATACTAATA
GGACGAAAAAAGTCACTTATCAGTATGCGC|GGAGCGTTATCCTAGGGCTTTGCTCTCGCA
TGCATGTCTTCACGCGAAGGCATACGCCGT|CGCATGAGCGATCAAGGGCCTATACGGTGC
TGTCTTCACGCGAAGGCATACGCCGTGGAC|TCGCCCGTAGTATTTCTCATGTCTTCACGC
AAGATTAGGGTTGAAACGTCATGTCTTCAC|CCGTGCACCGACCATTGCCAATATGGACGA
GTGTTCAACACCACGCTGGCTCATGTCTTC|CCGTGTCATGTCTTCACGCGAAGGCATACG
TCAAGCTGGCTTAGTAAAGTCCTAGCACCG|TGACCGGGTGCCCTCTCATGTCTTCACGCG
GCCGTGCCTGGATTATCATGTCTTCACGCG|TACCGCGGAGTCCCTGTGATGCCCGAGAGA
TTTCTCATGTCTTCACGCGAAGGCATACGC|GCTTTTATACCGCTTGAACCATCGATGGGA
GCTCGCCCGTAGTATTTCTCATGTCTTCAC|TACGCCGTGCGTGTGCTTTTATACCGCTTG
GTAAACTCACAAATTTCAAACTTAGTTTCG|GTCATGTCTTCACGCGAAGGCATACGCCGT
GCATACGCCGTGTTCATACCTTACCGCGGA|GTCCACTCCGTCATGTAAAATCCGAGTGTC
CACGCGAAGGCATACGCCGTGCCTGGATTA|GCCGTGTTCATACCTTACCGCGGAGTCCCT
TGGGACTTAGCGCCGAAAACTATCATGTCT|TAGGAGACGAGTCCCGACTGGCGTTACTAG
CCGTGGACGATCGAGTCATGTCTTCACGCG|CTTCACGCGAAGGCATACGCCGTGATGTCT
AACGTCATGTCTTCACGCGAAGGCATACGC|TTGCCAATATGGACGAAAAAAGTCACTTAT
TAGGGTTGAAACGTCATGTCTTCACGCGAA|CACCGACCATTGCCAATATGGACGAAAAAA
TGTCTTCACGCGAAGGCATACGCCGTGTTG|ATGCCCGAGAGAAACGCGTATGACGGTGAA
TCGGGTGTAGATGCTAAAAATCTGGGTAGT|GTGGTTTTGGAGGCCTCTCGTCCAATTTCA
CCATCCCCTACTATCACAGGTGGTCCGGCT|TCAAGGATATGAGTATGAGGGTATAAGTAA
GTGCATGTCTTCACGCGAAGGCATACGCCG|ACGCATGAGCGATCAAGGGCCTATACGGTG
GCGCCGAAAACTATCATGTCTTCACGCGAA|AGTCCCGACTGGCGTTACTAGGTTATTCAT
CGCTTGAACCATCGATGGGACTTAGCGCCG|ACGGGGATAAGTCCCTAGGAGACGAGTCCC
TTAGTTTCGTTCGGGTGTAGATGCTAAAAA|ATACGCCGTGGTGGTTTTGGAGGCCTCTCG
TTCAACACCACGCTGGCTCATGTCTTCACG|TGTCATGTCTTCACGCGAAGGCATACGCCG
ACTGGCGTTACTAGGTTATTCATGTCATGT|TCCTAGCACCGCCGCAAGCTGGTGTTCAAC
GCCATTGAGAGCGATCACACGGGGATAAGT|TCGGTCTCACGGTGATCCTAGAAGGCCTGT
CTCATGTCTTCACGCGAAGGCATACGCCGT|TTTATACCGCTTGAACCATCGATGGGACTT
CTCACAAATTTCAAACTTAGTTTCGTTCGG|GTCTTCACGCGAAGGCATACGCCGTGGTGG
TCTTCACGCGAAGGCATACGCCGTGCCGTT|CCGAAAACTATCATGTCTTCACGCGAAGGC
GGGGGGCCTCACGTTGTCTGCCAGTAGCGC|TCGATGCCCCATCCCCTACTATCACAGGTG
GCGGGCTCGCCCGTAGTATTTCTCATGTCT|GGCATACGCCGTGCGTGTGCTTTTATACCG
CTATCATGTCTTCACGCGAAGGCATACGCC|GGCGTTACTAGGTTATTCATGTCATGTCTT
CTTCACGCGAAGGCATACGCCGTGTCTTCA|ACCACGCTGGCTCATGTCTTCACGCGAAGG
GCGATCAAGGGCCTATACGGTGCCATTGAG|CGCGAAGGCATACGCCGTGATTCGGTCTCA
CGCGAAGGCATACGCCGTGTTGACCGGGTG|GAGAAACGCGTATGACGGTGAACTTGCAAG
AGGCATACGCCGTGCACCGACCATTGCCAA|ATACGCCGTGAGATTATAACCTTGTCACGT
CCAGGCTAGGCGTGGACGCTCGTCCACTCC|CCGGCTGCGTGGTCCATTCTAAATGCTATC
CCGTGGCGAACGGACGATGTTACGCATGAG|TTCACGCGAAGGCATACGCCGTGTCTTCAC
ATGTAAAATCCGAGTGTCAACGGTTAGGCT|TAGACTGCCTGTGGGACCTGCTCCATGTGA
GTCATGTCTTCACGCGAAGGCATACGCCGT|CCAATATGGACGAAAAAAGTCACTTATCAG
AGCTGGTGTTCAACACCACGCTGGCTCATG|ATACGCCGTGTCATGTCTTCACGCGAAGGC
GTACCAATTTTCCCTAAACTATTGGCCTTG|CTCTAGTTCCTCATGTCTTCACGCGAAGGC
GGGTTGAAACGTCATGTCTTCACGCGAAGG|CCGACCATTGCCAATATGGACGAAAAAAGT
GGCATACGCCGTGGACGATCGAGTCATGTC|TCTCATGTCTTCACGCGAAGGCATACGCCG
GACCATTGCCAATATGGACGAAAAAAGTCA|ACCTTGTCACGTCCGGGAGCGTTATCCTAG
CGCGAAGGCATACGCCGTGCCGTTCATGTC|ACTATCATGTCTTCACGCGAAGGCATACGC
CCATTGAGAGCGATCACACGGGGATAAGTC|CGGTCTCACGGTGATCCTAGAAGGCCTGTT
GTGCCTGGATTATCATGTCTTCACGCGAAG|CGCGGAGTCCCTGTGATGCCCGAGAGAAAC
CTAAAAATCTGGGTAGTTAGCTTTTAAGAA|CCTCTCGTCCAATTTCACAACCGGTGCCAA
CTTCACGCGAAGGCATACGCCGTGATTCGG|GAAGGCATACGCCGTGCCTGGATTATCATG
CGTGCACCGACCATTGCCAATATGGACGAA|AGATTATAACCTTGTCACGTCCGGGAGCGT
CAAGCTGGCTTAGTAAAGTCCTAGCACCGC|GACCGGGTGCCCTCTCATGTCTTCACGCGA
TATCATGTCTTCACGCGAAGGCATACGCCG|CTGTGATGCCCGAGAGAAACGCGTATGACG
TCGTCCACTCCGTCATGTAAAATCCGAGTG|TAAATGCTATCCGCTAGACTGCCTGTGGGA
CTCGCACAACGCGGGCTCGCCCGTAGTATT|TTCACGCGAAGGCATACGCCGTGCGTGTGC
CGAAGGCATACGCCGTGCATGTCTTCACGC|GAACGGACGATGTTACGCATGAGCGATCAA
ATGTCTTCACGCGAAGGCATACGCCGTGCC|GGCATACGCCGTGTTCATACCTTACCGCGG
TATACCGCTTGAACCATCGATGGGACTTAG|ATCACACGGGGATAAGTCCCTAGGAGACGA
CGCGAAGGCATACGCCGTGTCTTCACGCGA|GCTGGCTCATGTCTTCACGCGAAGGCATAC
ATTGCCAATATGGACGAAAAAAGTCACTTA|TGTCACGTCCGGGAGCGTTATCCTAGGGCT
GCCGTGAGATTATAACCTTGTCACGTCCGG|GGCATACGCCGTGCCGTTCATGTCTTCACG
TAAAGTCCTAGCACCGCCGCAAGCTGGTGT|CTCATGTCTTCACGCGAAGGCATACGCCGT
CGAAGGCATACGCCGTGTTGACCGGGTGCC|GAAACGCGTATGACGGTGAACTTGCAAGGG
GAAGGCATACGCCGTGGACGATCGAGTCAT|ATTTCTCATGTCTTCACGCGAAGGCATACG
GTGATGCCCGAGAGAAACGCGTATGACGGT|TAGGCTCACCCCAGGACTCACTATTGGCAC
ATCCGAGTGTCAACGGTTAGGCTCACCCCA|CCTGTGGGACCTGCTCCATGTGAACTAGGC
AAATTTGTACCAATTTTCCCTAAACTATTG|AATTGACTCTAGTTCCTCATGTCTTCACGC
AGCGATCACACGGGGATAAGTCCCTAGGAG|CGGTGATCCTAGAAGGCCTGTTCAAGCTGG
AACTTGCAAGGGGGGGCCTCACGTTGTCTG|AAGTTCCTTTTCGATGCCCCATCCCCTACT
CCAGTAGCGCCCCCAGGCTAGGCGTGGACG|ATCACAGGTGGTCCGGCTGCGTGGTCCATT
ACGCGAAGGCATACGCCGTGCGTGTGCTTT|TCAAGGGCCTATACGGTGCCATTGAGAGCG
GCCCGTAGTATTTCTCATGTCTTCACGCGA|CCGTGCGTGTGCTTTTATACCGCTTGAACC
CAATTGACTCTAGTTCCTCATGTCTTCACG|GTGGACGATCGAGTCATGTCTTCACGCGAA
TTGGAGGCCTCTCGTCCAATTTCACAACCG|GTGCCTGTCATGTCTTCACGCGAAGGCATA
TACCGCTTGAACCATCGATGGGACTTAGCG|CACACGGGGATAAGTCCCTAGGAGACGAGT
ACTAGGTTATTCATGTCATGTCTTCACGCG|CGCCGCAAGCTGGTGTTCAACACCACGCTG
GGCATACGCCGTGTCTTCACGCGAAGGCAT|TCATGTCTTCACGCGAAGGCATACGCCGTG
GAAGGCATACGCCGTGCGTGTGCTTTTATA|GGGCCTATACGGTGCCATTGAGAGCGATCA
TATCACAGGTGGTCCGGCTGCGTGGTCCAT|AGTATGAGGGTATAAGTAACAAGCCCGGGA
TTGACCGGGTGCCCTCTCATGTCTTCACGC|GAACTTGCAAGGGGGGGCCTCACGTTGTCT
TGTGATGCCCGAGAGAAACGCGTATGACGG|TTAGGCTCACCCCAGGACTCACTATTGGCA
ATGTCTTCACGCGAAGGCATACGCCGTGCG|ATGAGCGATCAAGGGCCTATACGGTGCCAT
TGTACCAATTTTCCCTAAACTATTGGCCTT|ACTCTAGTTCCTCATGTCTTCACGCGAAGG
CATGTCATGTCTTCACGCGAAGGCATACGC|GGTGTTCAACACCACGCTGGCTCATGTCTT
TGCCAATTGACTCTAGTTCCTCATGTCTTC|GCCGTGGACGATCGAGTCATGTCTTCACGC
AGACGAGTCCCGACTGGCGTTACTAGGTTA|GGCTTAGTAAAGTCCTAGCACCGCCGCAAG
GGACTTAGCGCCGAAAACTATCATGTCTTC|GGAGACGAGTCCCGACTGGCGTTACTAGGT
GAGAGAAACGCGTATGACGGTGAACTTGCA|CCCAGGACTCACTATTGGCACAAAGTTCCT
CATGTAAAATCCGAGTGTCAACGGTTAGGC|CTAGACTGCCTGTGGGACCTGCTCCATGTG
TATTTCTCATGTCTTCACGCGAAGGCATAC|GTGCTTTTATACCGCTTGAACCATCGATGG
GGTGGTTTTGGAGGCCTCTCGTCCAATTTC|TATGCGCGTGCCTGTCATGTCTTCACGCGA
GCTGGTGTTCAACACCACGCTGGCTCATGT|TACGCCGTGTCATGTCTTCACGCGAAGGCA
GTCAACGGTTAGGCTCACCCCAGGACTCAC|ACCTGCTCCATGTGAACTAGGCACTGCCTG
AATTGACTCTAGTTCCTCATGTCTTCACGC|TGGACGATCGAGTCATGTCTTCACGCGAAG
AACTATCATGTCTTCACGCGAAGGCATACG|CTGGCGTTACTAGGTTATTCATGTCATGTC
CTGGCTTAGTAAAGTCCTAGCACCGCCGCA|GGGTGCCCTCTCATGTCTTCACGCGAAGGC
TGTCTGCCAGTAGCGCCCCCAGGCTAGGCG|CCTACTATCACAGGTGGTCCGGCTGCGTGG
GTCTTCACGCGAAGGCATACGCCGTGAGAT|CCGTGATGTCTTCACGCGAAGGCATACGCC
AGTCCCTGTGATGCCCGAGAGAAACGCGTA|CAACGGTTAGGCTCACCCCAGGACTCACTA
GGGCTCGCCCGTAGTATTTCTCATGTCTTC|CATACGCCGTGCGTGTGCTTTTATACCGCT
GGTTAGGCTCACCCCAGGACTCACTATTGG|TCCATGTGAACTAGGCACTGCCTGAAGGCT
AGAGAAACGCGTATGACGGTGAACTTGCAA|CCAGGACTCACTATTGGCACAAAGTTCCTT
GTGTCAACGGTTAGGCTCACCCCAGGACTC|GGACCTGCTCCATGTGAACTAGGCACTGCC
GAAGGCATACGCCGTGCATGTCTTCACGCG|AACGGACGATGTTACGCATGAGCGATCAAG
TGTCAACGGTTAGGCTCACCCCAGGACTCA|GACCTGCTCCATGTGAACTAGGCACTGCCT
CTAGGAGACGAGTCCCGACTGGCGTTACTA|AAGCTGGCTTAGTAAAGTCCTAGCACCGCC
GTTCCTCATGTCTTCACGCGAAGGCATACG|GTCATGTCTTCACGCGAAGGCATACGCCGT
ATTATAACCTTGTCACGTCCGGGAGCGTTA|CCGTGCCGTTCATGTCTTCACGCGAAGGCA
AAAACTATCATGTCTTCACGCGAAGGCATA|GACTGGCGTTACTAGGTTATTCATGTCATG
CGCCGTGGTGGTTTTGGAGGCCTCTCGTCC|TATCAGTATGCGCGTGCCTGTCATGTCTTC
GGGATAAGTCCCTAGGAGACGAGTCCCGAC|AAGGCCTGTTCAAGCTGGCTTAGTAAAGTC
CGTTCGGGTGTAGATGCTAAAAATCTGGGT|GTGGTGGTTTTGGAGGCCTCTCGTCCAATT
CTAAACTATTGGCCTTGCGCCCAAGATTAG|TGTCTTCACGCGAAGGCATACGCCGTGCAC
TCCTAGGGCTTTGCTCTCGCACAACGCGGG|TACGCCGTGCATGTCTTCACGCGAAGGCAT
GCACAAAGTTCCTTTTCGATGCCCCATCCC|TTGTATACTAATACTGGGACGCCTCAAGGA
TGTCTTCACGCGAAGGCATACGCCGTGCCT|GCATACGCCGTGTTCATACCTTACCGCGGA
TATCCTAGGGCTTTGCTCTCGCACAACGCG|CATACGCCGTGCATGTCTTCACGCGAAGGC
TTCAAACTTAGTTTCGTTCGGGTGTAGATG|CGAAGGCATACGCCGTGGTGGTTTTGGAGG
TAGCTTTTAAGAAATTTGTACCAATTTTCC|CAACCGGTGCCAATTGACTCTAGTTCCTCA
ATGTCTTCACGCGAAGGCATACGCCGTGTC|CTCACGTTGTCTGCCAGTAGCGCCCCCAGG
TACGCCGTGCATGTCTTCACGCGAAGGCAT|GATGTTACGCATGAGCGATCAAGGGCCTAT
CACGCGAAGGCATACGCCGTGAGATTATAA|ATGTCTTCACGCGAAGGCATACGCCGTGCC
GAAGGCATACGCCGTGGCGAACGGACGATG|CATGTCATGTCTTCACGCGAAGGCATACGC
AAGGCATACGCCGTGTTCATACCTTACCGC|CTCGTCCACTCCGTCATGTAAAATCCGAGT
ACGCCGTGTCTTCACGCGAAGGCATACGCC|TCTTCACGCGAAGGCATACGCCGTGCCTGG
TACCAATTTTCCCTAAACTATTGGCCTTGC|TCTAGTTCCTCATGTCTTCACGCGAAGGCA
CGAGTCATGTCTTCACGCGAAGGCATACGC|GGCATACGCCGTGATGTCTTCACGCGAAGG
AGGCATACGCCGTGCCTGGATTATCATGTC|TCATACCTTACCGCGGAGTCCCTGTGATGC
GGACGATGTTACGCATGAGCGATCAAGGGC|GCATACGCCGTGTCTTCACGCGAAGGCATA
CGCGAAGGCATACGCCGTGATGTCTTCACG|GAACCATCGATGGGACTTAGCGCCGAAAAC
TCAACACCACGCTGGCTCATGTCTTCACGC|GTCATGTCTTCACGCGAAGGCATACGCCGT
TCACTATTGGCACAAAGTTCCTTTTCGATG|CCTGAAGGCTTGTATACTAATACTGGGACG
GCATACGCCGTGTTGACCGGGTGCCCTCTC|GCGTATGACGGTGAACTTGCAAGGGGGGGC
AGGGCTTTGCTCTCGCACAACGCGGGCTCG|CCGTGCATGTCTTCACGCGAAGGCATACGC
CGCCGTGATGTCTTCACGCGAAGGCATACG|GGACTTAGCGCCGAAAACTATCATGTCTTC
GTCACTTATCAGTATGCGCGTGCCTGTCAT|CTAGGGCTTTGCTCTCGCACAACGCGGGCT
TTCACGCGAAGGCATACGCCGTGGCGAACG|GGTTATTCATGTCATGTCTTCACGCGAAGG
GCATACGCCGTGGACGATCGAGTCATGTCT|CTCATGTCTTCACGCGAAGGCATACGCCGT
TTTCACAACCGGTGCCAATTGACTCTAGTT|GCGAAGGCATACGCCGTGGACGATCGAGTC
CGTTCATGTCTTCACGCGAAGGCATACGCC|AGGCATACGCCGTGGCGAACGGACGATGTT
AGTTCCTCATGTCTTCACGCGAAGGCATAC|AGTCATGTCTTCACGCGAAGGCATACGCCG
TCAAGGGCCTATACGGTGCCATTGAGAGCG|AAGGCATACGCCGTGATTCGGTCTCACGGT
TCGCCCGTAGTATTTCTCATGTCTTCACGC|CGCCGTGCGTGTGCTTTTATACCGCTTGAA
GTGATTCGGTCTCACGGTGATCCTAGAAGG|ATTATCATGTCTTCACGCGAAGGCATACGC
GTATGCGCGTGCCTGTCATGTCTTCACGCG|CTCTCGCACAACGCGGGCTCGCCCGTAGTA
GACGCTCGTCCACTCCGTCATGTAAAATCC|CATTCTAAATGCTATCCGCTAGACTGCCTG
GAAGGCATACGCCGTGCACCGACCATTGCC|GCATACGCCGTGAGATTATAACCTTGTCAC
TTAGCTTTTAAGAAATTTGTACCAATTTTC|ACAACCGGTGCCAATTGACTCTAGTTCCTC
CACCCCAGGACTCACTATTGGCACAAAGTT|ACTAGGCACTGCCTGAAGGCTTGTATACTA
GTCCCGACTGGCGTTACTAGGTTATTCATG|GTAAAGTCCTAGCACCGCCGCAAGCTGGTG
ATCACACGGGGATAAGTCCCTAGGAGACGA|GATCCTAGAAGGCCTGTTCAAGCTGGCTTA
TGTAGATGCTAAAAATCTGGGTAGTTAGCT|TTTGGAGGCCTCTCGTCCAATTTCACAACC
ACGCGAAGGCATACGCCGTGATGTCTTCAC|TGAACCATCGATGGGACTTAGCGCCGAAAA
GTCTTCACGCGAAGGCATACGCCGTGGTGG|ATGGACGAAAAAAGTCACTTATCAGTATGC
CACGCGAAGGCATACGCCGTGCGTGTGCTT|ATCAAGGGCCTATACGGTGCCATTGAGAGC
TGTCTTCACGCGAAGGCATACGCCGTGGTG|TATGGACGAAAAAAGTCACTTATCAGTATG
AAAAAGTCACTTATCAGTATGCGCGTGCCT|TTATCCTAGGGCTTTGCTCTCGCACAACGC
GTTATCCTAGGGCTTTGCTCTCGCACAACG|GGCATACGCCGTGCATGTCTTCACGCGAAG
TGCCCTCTCATGTCTTCACGCGAAGGCATA|AGGGGGGGCCTCACGTTGTCTGCCAGTAGC
CACGCGAAGGCATACGCCGTGCACCGACCA|CGAAGGCATACGCCGTGAGATTATAACCTT
CGCCCCCAGGCTAGGCGTGGACGCTCGTCC|GTGGTCCGGCTGCGTGGTCCATTCTAAATG
CTCATGTCTTCACGCGAAGGCATACGCCGT|GAAGGCATACGCCGTGTTCATACCTTACCG
ACCAATTTTCCCTAAACTATTGGCCTTGCG|CTAGTTCCTCATGTCTTCACGCGAAGGCAT
GTAAAATCCGAGTGTCAACGGTTAGGCTCA|GACTGCCTGTGGGACCTGCTCCATGTGAAC
TGTCTTCACGCGAAGGCATACGCCGTGTCT|AACACCACGCTGGCTCATGTCTTCACGCGA
ATTTTCCCTAAACTATTGGCCTTGCGCCCA|TTCCTCATGTCTTCACGCGAAGGCATACGC
TTCACGCGAAGGCATACGCCGTGTTGACCG|CCGAGAGAAACGCGTATGACGGTGAACTTG
CGTGCATGTCTTCACGCGAAGGCATACGCC|TACGCATGAGCGATCAAGGGCCTATACGGT
ATGTCTTCACGCGAAGGCATACGCCGTGCA|CTTCACGCGAAGGCATACGCCGTGAGATTA
GGCATACGCCGTGCCGTTCATGTCTTCACG|ATGTCTTCACGCGAAGGCATACGCCGTGGC
TCTTCACGCGAAGGCATACGCCGTGTTCAT|GGCGTGGACGCTCGTCCACTCCGTCATGTA
TTCACGCGAAGGCATACGCCGTGCATGTCT|CGTGGCGAACGGACGATGTTACGCATGAGC
GTGGACGCTCGTCCACTCCGTCATGTAAAA|GTCCATTCTAAATGCTATCCGCTAGACTGC
TACGCCGTGCCTGGATTATCATGTCTTCAC|CCTTACCGCGGAGTCCCTGTGATGCCCGAG
CTAGGCGTGGACGCTCGTCCACTCCGTCAT|TGCGTGGTCCATTCTAAATGCTATCCGCTA
TCTCGTCCAATTTCACAACCGGTGCCAATT|ATGTCTTCACGCGAAGGCATACGCCGTGGA
ACGGTGCCATTGAGAGCGATCACACGGGGA|GTGATTCGGTCTCACGGTGATCCTAGAAGG
CCCGTAGTATTTCTCATGTCTTCACGCGAA|CGTGCGTGTGCTTTTATACCGCTTGAACCA
GCGAAGGCATACGCCGTGAGATTATAACCT|TCTTCACGCGAAGGCATACGCCGTGCCGTT
TTCACGCGAAGGCATACGCCGTGTTCATAC|CGTGGACGCTCGTCCACTCCGTCATGTAAA
CACCGCCGCAAGCTGGTGTTCAACACCACG|ACGCGAAGGCATACGCCGTGTCATGTCTTC
GGGGGGGCCTCACGTTGTCTGCCAGTAGCG|TTCGATGCCCCATCCCCTACTATCACAGGT
GAGCGATCAAGGGCCTATACGGTGCCATTG|CACGCGAAGGCATACGCCGTGATTCGGTCT
CAATTTTCCCTAAACTATTGGCCTTGCGCC|AGTTCCTCATGTCTTCACGCGAAGGCATAC
CCGTGATGTCTTCACGCGAAGGCATACGCC|ACTTAGCGCCGAAAACTATCATGTCTTCAC
CTAGGGCTTTGCTCTCGCACAACGCGGGCT|CGCCGTGCATGTCTTCACGCGAAGGCATAC
GCCGTGTTCATACCTTACCGCGGAGTCCCT|TCCGTCATGTAAAATCCGAGTGTCAACGGT
ACAGGTGGTCCGGCTGCGTGGTCCATTCTA|TGAGGGTATAAGTAACAAGCCCGGGAAAAC
CGAAGGCATACGCCGTGTCATGTCTTCACG|TGCCAGTAGCGCCCCCAGGCTAGGCGTGGA
AGCTGGCTTAGTAAAGTCCTAGCACCGCCG|CCGGGTGCCCTCTCATGTCTTCACGCGAAG
TCCTAGAAGGCCTGTTCAAGCTGGCTTAGT|AGGCATACGCCGTGTTGACCGGGTGCCCTC
AAACTTAGTTTCGTTCGGGTGTAGATGCTA|AGGCATACGCCGTGGTGGTTTTGGAGGCCT
CCGTGCACCGACCATTGCCAATATGGACGA|GAGATTATAACCTTGTCACGTCCGGGAGCG
GTCTGCCAGTAGCGCCCCCAGGCTAGGCGT|CTACTATCACAGGTGGTCCGGCTGCGTGGT
GCCCAAGATTAGGGTTGAAACGTCATGTCT|TACGCCGTGCACCGACCATTGCCAATATGG
TCTTCACGCGAAGGCATACGCCGTGTCATG|ACGTTGTCTGCCAGTAGCGCCCCCAGGCTA
GTTCAACACCACGCTGGCTCATGTCTTCAC|GTGTCATGTCTTCACGCGAAGGCATACGCC
GCTTAGTAAAGTCCTAGCACCGCCGCAAGC|TGCCCTCTCATGTCTTCACGCGAAGGCATA
TCTTCACGCGAAGGCATACGCCGTGTCTTC|CACCACGCTGGCTCATGTCTTCACGCGAAG
CTTCACGCGAAGGCATACGCCGTGCGTGTG|GCGATCAAGGGCCTATACGGTGCCATTGAG
CCGGGTGCCCTCTCATGTCTTCACGCGAAG|TTGCAAGGGGGGGCCTCACGTTGTCTGCCA
TTACCGCGGAGTCCCTGTGATGCCCGAGAG|TCCGAGTGTCAACGGTTAGGCTCACCCCAG
TTAGTAAAGTCCTAGCACCGCCGCAAGCTG|CCCTCTCATGTCTTCACGCGAAGGCATACG
ATCTGGGTAGTTAGCTTTTAAGAAATTTGT|GTCCAATTTCACAACCGGTGCCAATTGACT
CGAGAGAAACGCGTATGACGGTGAACTTGC|CCCCAGGACTCACTATTGGCACAAAGTTCC
CACGCGAAGGCATACGCCGTGTTGACCGGG|GAGAGAAACGCGTATGACGGTGAACTTGCA
ATACGCCGTGTTCATACCTTACCGCGGAGT|CCACTCCGTCATGTAAAATCCGAGTGTCAA
GGCGAACGGACGATGTTACGCATGAGCGAT|CGCGAAGGCATACGCCGTGTCTTCACGCGA
GTCTTCACGCGAAGGCATACGCCGTGCGTG|GAGCGATCAAGGGCCTATACGGTGCCATTG
AGCGTTATCCTAGGGCTTTGCTCTCGCACA|GAAGGCATACGCCGTGCATGTCTTCACGCG
GCGAAGGCATACGCCGTGGACGATCGAGTC|GTATTTCTCATGTCTTCACGCGAAGGCATA
CGTCCACTCCGTCATGTAAAATCCGAGTGT|AAATGCTATCCGCTAGACTGCCTGTGGGAC
GGATAAGTCCCTAGGAGACGAGTCCCGACT|AGGCCTGTTCAAGCTGGCTTAGTAAAGTCC
GCCGTGGTGGTTTTGGAGGCCTCTCGTCCA|ATCAGTATGCGCGTGCCTGTCATGTCTTCA
GCCGTGCACCGACCATTGCCAATATGGACG|TGAGATTATAACCTTGTCACGTCCGGGAGC
AAGGCATACGCCGTGGTGGTTTTGGAGGCC|AAGTCACTTATCAGTATGCGCGTGCCTGTC
TATGGACGAAAAAAGTCACTTATCAGTATG|CCGGGAGCGTTATCCTAGGGCTTTGCTCTC
ACCTTACCGCGGAGTCCCTGTGATGCCCGA|AAATCCGAGTGTCAACGGTTAGGCTCACCC
TTTGCTCTCGCACAACGCGGGCTCGCCCGT|CATGTCTTCACGCGAAGGCATACGCCGTGC
TGTCATGTCTTCACGCGAAGGCATACGCCG|TGTTCAACACCACGCTGGCTCATGTCTTCA
CAAGCTGGTGTTCAACACCACGCTGGCTCA|GCATACGCCGTGTCATGTCTTCACGCGAAG
GCCGTGTCTTCACGCGAAGGCATACGCCGT|TTCACGCGAAGGCATACGCCGTGCCTGGAT
GGTAGTTAGCTTTTAAGAAATTTGTACCAA|ATTTCACAACCGGTGCCAATTGACTCTAGT
ATCCCCTACTATCACAGGTGGTCCGGCTGC|AAGGATATGAGTATGAGGGTATAAGTAACA
CCGTGCATGTCTTCACGCGAAGGCATACGC|TTACGCATGAGCGATCAAGGGCCTATACGG
GACCGGGTGCCCTCTCATGTCTTCACGCGA|ACTTGCAAGGGGGGGCCTCACGTTGTCTGC
GACGAGTCCCGACTGGCGTTACTAGGTTAT|GCTTAGTAAAGTCCTAGCACCGCCGCAAGC
CCCCTACTATCACAGGTGGTCCGGCTGCGT|GGATATGAGTATGAGGGTATAAGTAACAAG
GTCCACTCCGTCATGTAAAATCCGAGTGTC|AATGCTATCCGCTAGACTGCCTGTGGGACC
ATACGCCGTGCATGTCTTCACGCGAAGGCA|CGATGTTACGCATGAGCGATCAAGGGCCTA
CGTTGTCTGCCAGTAGCGCCCCCAGGCTAG|TCCCCTACTATCACAGGTGGTCCGGCTGCG
GTCACGTCCGGGAGCGTTATCCTAGGGCTT|ATGTCTTCACGCGAAGGCATACGCCGTGCA
TCATGTCTTCACGCGAAGGCATACGCCGTG|TTCAACACCACGCTGGCTCATGTCTTCACG
TGAAACGTCATGTCTTCACGCGAAGGCATA|CCATTGCCAATATGGACGAAAAAAGTCACT
TCACGCGAAGGCATACGCCGTGTCATGTCT|TTGTCTGCCAGTAGCGCCCCCAGGCTAGGC
TTTATACCGCTTGAACCATCGATGGGACTT|CGATCACACGGGGATAAGTCCCTAGGAGAC
TACGCCGTGGTGGTTTTGGAGGCCTCTCGT|CTTATCAGTATGCGCGTGCCTGTCATGTCT
ATGACGGTGAACTTGCAAGGGGGGGCCTCA|ATTGGCACAAAGTTCCTTTTCGATGCCCCA
TCTCATGTCTTCACGCGAAGGCATACGCCG|TTTTATACCGCTTGAACCATCGATGGGACT
CATACGCCGTGCGTGTGCTTTTATACCGCT|TATACGGTGCCATTGAGAGCGATCACACGG
CTAGTTCCTCATGTCTTCACGCGAAGGCAT|CGAGTCATGTCTTCACGCGAAGGCATACGC
GAAGGCATACGCCGTGATGTCTTCACGCGA|CCATCGATGGGACTTAGCGCCGAAAACTAT
GAAGGCATACGCCGTGCCGTTCATGTCTTC|ATCATGTCTTCACGCGAAGGCATACGCCGT
CCCTCTCATGTCTTCACGCGAAGGCATACG|GGGGGGCCTCACGTTGTCTGCCAGTAGCGC
ATACCGCTTGAACCATCGATGGGACTTAGC|TCACACGGGGATAAGTCCCTAGGAGACGAG
TATTGGCACAAAGTTCCTTTTCGATGCCCC|AAGGCTTGTATACTAATACTGGGACGCCTC
CAACGCGGGCTCGCCCGTAGTATTTCTCAT|CGAAGGCATACGCCGTGCGTGTGCTTTTAT
CGTGCCGTTCATGTCTTCACGCGAAGGCAT|CGCGAAGGCATACGCCGTGGCGAACGGACG
GCCAGTAGCGCCCCCAGGCTAGGCGTGGAC|TATCACAGGTGGTCCGGCTGCGTGGTCCAT
TTCACAACCGGTGCCAATTGACTCTAGTTC|CGAAGGCATACGCCGTGGACGATCGAGTCA
CCACTCCGTCATGTAAAATCCGAGTGTCAA|TGCTATCCGCTAGACTGCCTGTGGGACCTG
ACGCCGTGCACCGACCATTGCCAATATGGA|CGTGAGATTATAACCTTGTCACGTCCGGGA
TAACCTTGTCACGTCCGGGAGCGTTATCCT|GCCGTTCATGTCTTCACGCGAAGGCATACG
TGTGCTTTTATACCGCTTGAACCATCGATG|TGAGAGCGATCACACGGGGATAAGTCCCTA
CGGAGTCCCTGTGATGCCCGAGAGAAACGC|TGTCAACGGTTAGGCTCACCCCAGGACTCA
GGCCTGTTCAAGCTGGCTTAGTAAAGTCCT|GCCGTGTTGACCGGGTGCCCTCTCATGTCT
CGAAGGCATACGCCGTGCGTGTGCTTTTAT|AGGGCCTATACGGTGCCATTGAGAGCGATC
CCTCTCATGTCTTCACGCGAAGGCATACGC|GGGGGCCTCACGTTGTCTGCCAGTAGCGCC
AAAATCCGAGTGTCAACGGTTAGGCTCACC|CTGCCTGTGGGACCTGCTCCATGTGAACTA
CGATCAAGGGCCTATACGGTGCCATTGAGA|GCGAAGGCATACGCCGTGATTCGGTCTCAC
GATCGAGTCATGTCTTCACGCGAAGGCATA|GAAGGCATACGCCGTGATGTCTTCACGCGA
CCTGTTCAAGCTGGCTTAGTAAAGTCCTAG|CGTGTTGACCGGGTGCCCTCTCATGTCTTC
CTCACCCCAGGACTCACTATTGGCACAAAG|GAACTAGGCACTGCCTGAAGGCTTGTATAC
TCATGTCTTCACGCGAAGGCATACGCCGTG|GGCTAGGCGTGGACGCTCGTCCACTCCGTC
ACCATCGATGGGACTTAGCGCCGAAAACTA|TAAGTCCCTAGGAGACGAGTCCCGACTGGC
TCCCTAAACTATTGGCCTTGCGCCCAAGAT|TCATGTCTTCACGCGAAGGCATACGCCGTG
TCATGTCTTCACGCGAAGGCATACGCCGTG|GCCTCACGTTGTCTGCCAGTAGCGCCCCCA
GTCATGTCTTCACGCGAAGGCATACGCCGT|GTTCAACACCACGCTGGCTCATGTCTTCAC
AACTATTGGCCTTGCGCCCAAGATTAGGGT|CTTCACGCGAAGGCATACGCCGTGCACCGA
CGCCCAAGATTAGGGTTGAAACGTCATGTC|ATACGCCGTGCACCGACCATTGCCAATATG
ATTTGTACCAATTTTCCCTAAACTATTGGC|TTGACTCTAGTTCCTCATGTCTTCACGCGA
AAAAATCTGGGTAGTTAGCTTTTAAGAAAT|TCTCGTCCAATTTCACAACCGGTGCCAATT
CTATACGGTGCCATTGAGAGCGATCACACG|CGCCGTGATTCGGTCTCACGGTGATCCTAG
GAGCGATCACACGGGGATAAGTCCCTAGGA|ACGGTGATCCTAGAAGGCCTGTTCAAGCTG
ACGCCGTGTTCATACCTTACCGCGGAGTCC|ACTCCGTCATGTAAAATCCGAGTGTCAACG
AAAGTTCCTTTTCGATGCCCCATCCCCTAC|ATACTAATACTGGGACGCCTCAAGGATATG
GAGCGTTATCCTAGGGCTTTGCTCTCGCAC|CGAAGGCATACGCCGTGCATGTCTTCACGC
GTGAACTTGCAAGGGGGGGCCTCACGTTGT|ACAAAGTTCCTTTTCGATGCCCCATCCCCT
AGTCCCTAGGAGACGAGTCCCGACTGGCGT|TGTTCAAGCTGGCTTAGTAAAGTCCTAGCA
AAGGCATACGCCGTGCGTGTGCTTTTATAC|GGCCTATACGGTGCCATTGAGAGCGATCAC
CACTCCGTCATGTAAAATCCGAGTGTCAAC|GCTATCCGCTAGACTGCCTGTGGGACCTGC
GAGATTATAACCTTGTCACGTCCGGGAGCG|ACGCCGTGCCGTTCATGTCTTCACGCGAAG
ATGCCCGAGAGAAACGCGTATGACGGTGAA|GCTCACCCCAGGACTCACTATTGGCACAAA
CGCCGTGGACGATCGAGTCATGTCTTCACG|GTCTTCACGCGAAGGCATACGCCGTGATGT
GTTTTGGAGGCCTCTCGTCCAATTTCACAA|CGCGTGCCTGTCATGTCTTCACGCGAAGGC
TTGAGAGCGATCACACGGGGATAAGTCCCT|TCTCACGGTGATCCTAGAAGGCCTGTTCAA
GCTAGGCGTGGACGCTCGTCCACTCCGTCA|CTGCGTGGTCCATTCTAAATGCTATCCGCT
ACGCTCGTCCACTCCGTCATGTAAAATCCG|ATTCTAAATGCTATCCGCTAGACTGCCTGT
GGAGGCCTCTCGTCCAATTTCACAACCGGT|GCCTGTCATGTCTTCACGCGAAGGCATACG
AGCGCCCCCAGGCTAGGCGTGGACGCTCGT|AGGTGGTCCGGCTGCGTGGTCCATTCTAAA
ATCAAGGGCCTATACGGTGCCATTGAGAGC|GAAGGCATACGCCGTGATTCGGTCTCACGG
AGGCATACGCCGTGATTCGGTCTCACGGTG|GCCGTGCCTGGATTATCATGTCTTCACGCG
ACGCGAAGGCATACGCCGTGTCTTCACGCG|CGCTGGCTCATGTCTTCACGCGAAGGCATA
CTACTATCACAGGTGGTCCGGCTGCGTGGT|TATGAGTATGAGGGTATAAGTAACAAGCCC
GTTAGCTTTTAAGAAATTTGTACCAATTTT|CACAACCGGTGCCAATTGACTCTAGTTCCT
TGGTGGTTTTGGAGGCCTCTCGTCCAATTT|GTATGCGCGTGCCTGTCATGTCTTCACGCG
CATACGCCGTGAGATTATAACCTTGTCACG|GCGAAGGCATACGCCGTGCCGTTCATGTCT
TAGCACCGCCGCAAGCTGGTGTTCAACACC|TTCACGCGAAGGCATACGCCGTGTCATGTC
GGATTATCATGTCTTCACGCGAAGGCATAC|GTCCCTGTGATGCCCGAGAGAAACGCGTAT
GGCCTCACGTTGTCTGCCAGTAGCGCCCCC|TGCCCCATCCCCTACTATCACAGGTGGTCC
GCGTGGACGCTCGTCCACTCCGTCATGTAA|TGGTCCATTCTAAATGCTATCCGCTAGACT
GTCCCTGTGATGCCCGAGAGAAACGCGTAT|AACGGTTAGGCTCACCCCAGGACTCACTAT
AACACCACGCTGGCTCATGTCTTCACGCGA|CATGTCTTCACGCGAAGGCATACGCCGTGT
ATGTCTTCACGCGAAGGCATACGCCGTGGA|CTCGCCCGTAGTATTTCTCATGTCTTCACG
CGTGTTGACCGGGTGCCCTCTCATGTCTTC|CGGTGAACTTGCAAGGGGGGGCCTCACGTT
GATCACACGGGGATAAGTCCCTAGGAGACG|TGATCCTAGAAGGCCTGTTCAAGCTGGCTT
CTATTGGCCTTGCGCCCAAGATTAGGGTTG|TCACGCGAAGGCATACGCCGTGCACCGACC
AAACTATTGGCCTTGCGCCCAAGATTAGGG|TCTTCACGCGAAGGCATACGCCGTGCACCG
GTCTTCACGCGAAGGCATACGCCGTGATTC|GCGAAGGCATACGCCGTGCCTGGATTATCA
ACCACGCTGGCTCATGTCTTCACGCGAAGG|GTCTTCACGCGAAGGCATACGCCGTGTTCA
AGTAAACTCACAAATTTCAAACTTAGTTTC|CGTCATGTCTTCACGCGAAGGCATACGCCG
TCATGTCTTCACGCGAAGGCATACGCCGTG|CATACGCCGTGGCGAACGGACGATGTTACG
CAACGGTTAGGCTCACCCCAGGACTCACTA|CTGCTCCATGTGAACTAGGCACTGCCTGAA
ACGCGTATGACGGTGAACTTGCAAGGGGGG|CTCACTATTGGCACAAAGTTCCTTTTCGAT
CACGCGAAGGCATACGCCGTGTCTTCACGC|ACGCTGGCTCATGTCTTCACGCGAAGGCAT
ATTAGGGTTGAAACGTCATGTCTTCACGCG|TGCACCGACCATTGCCAATATGGACGAAAA
TGTCTTCACGCGAAGGCATACGCCGTGATG|TACCGCTTGAACCATCGATGGGACTTAGCG
TCTAGTTCCTCATGTCTTCACGCGAAGGCA|TCGAGTCATGTCTTCACGCGAAGGCATACG
CCGAGAGAAACGCGTATGACGGTGAACTTG|ACCCCAGGACTCACTATTGGCACAAAGTTC
CACAACCGGTGCCAATTGACTCTAGTTCCT|AAGGCATACGCCGTGGACGATCGAGTCATG
CACGCGAAGGCATACGCCGTGGACGATCGA|GTAGTATTTCTCATGTCTTCACGCGAAGGC
CAAGGGCCTATACGGTGCCATTGAGAGCGA|AGGCATACGCCGTGATTCGGTCTCACGGTG
TTGTCACGTCCGGGAGCGTTATCCTAGGGC|TCATGTCTTCACGCGAAGGCATACGCCGTG
GTAGCGCCCCCAGGCTAGGCGTGGACGCTC|ACAGGTGGTCCGGCTGCGTGGTCCATTCTA
AGGCCTGTTCAAGCTGGCTTAGTAAAGTCC|CGCCGTGTTGACCGGGTGCCCTCTCATGTC
GTGGTTTTGGAGGCCTCTCGTCCAATTTCA|ATGCGCGTGCCTGTCATGTCTTCACGCGAA
ACGCTGGCTCATGTCTTCACGCGAAGGCAT|TTCACGCGAAGGCATACGCCGTGTTCATAC
CGGGTGCCCTCTCATGTCTTCACGCGAAGG|TGCAAGGGGGGGCCTCACGTTGTCTGCCAG
AGTCCCGACTGGCGTTACTAGGTTATTCAT|AGTAAAGTCCTAGCACCGCCGCAAGCTGGT
CTCTCGCACAACGCGGGCTCGCCCGTAGTA|TCTTCACGCGAAGGCATACGCCGTGCGTGT
GAACCATCGATGGGACTTAGCGCCGAAAAC|GATAAGTCCCTAGGAGACGAGTCCCGACTG
CACTATTGGCACAAAGTTCCTTTTCGATGC|CTGAAGGCTTGTATACTAATACTGGGACGC
GTTATTCATGTCATGTCTTCACGCGAAGGC|CAAGCTGGTGTTCAACACCACGCTGGCTCA
CGCCGTGTTGACCGGGTGCCCTCTCATGTC|TGACGGTGAACTTGCAAGGGGGGGCCTCAC
AAGGGGGGGCCTCACGTTGTCTGCCAGTAG|TTTTCGATGCCCCATCCCCTACTATCACAG
TCCTAGCACCGCCGCAAGCTGGTGTTCAAC|GTCTTCACGCGAAGGCATACGCCGTGTCAT
GCGAAGGCATACGCCGTGCCGTTCATGTCT|CTATCATGTCTTCACGCGAAGGCATACGCC
GTCTCACGGTGATCCTAGAAGGCCTGTTCA|GTCTTCACGCGAAGGCATACGCCGTGTTGA
GCTTTTATACCGCTTGAACCATCGATGGGA|GAGCGATCACACGGGGATAAGTCCCTAGGA
ATACGCCGTGTCATGTCTTCACGCGAAGGC|AGCGCCCCCAGGCTAGGCGTGGACGCTCGT
CGCGAAGGCATACGCCGTGCGTGTGCTTTT|CAAGGGCCTATACGGTGCCATTGAGAGCGA
TTCATGTCTTCACGCGAAGGCATACGCCGT|GCATACGCCGTGGCGAACGGACGATGTTAC
CGCCGTGATTCGGTCTCACGGTGATCCTAG|CTGGATTATCATGTCTTCACGCGAAGGCAT
ACGCCGTGTTGACCGGGTGCCCTCTCATGT|ATGACGGTGAACTTGCAAGGGGGGGCCTCA
TGCTTTTATACCGCTTGAACCATCGATGGG|AGAGCGATCACACGGGGATAAGTCCCTAGG
CCAGGACTCACTATTGGCACAAAGTTCCTT|GGCACTGCCTGAAGGCTTGTATACTAATAC
GCCGTGATTCGGTCTCACGGTGATCCTAGA|TGGATTATCATGTCTTCACGCGAAGGCATA
TTAGGGTTGAAACGTCATGTCTTCACGCGA|GCACCGACCATTGCCAATATGGACGAAAAA
GTGCACCGACCATTGCCAATATGGACGAAA|GATTATAACCTTGTCACGTCCGGGAGCGTT
AGAAGGCCTGTTCAAGCTGGCTTAGTAAAG|ATACGCCGTGTTGACCGGGTGCCCTCTCAT
TCGATGCCCCATCCCCTACTATCACAGGTG|GGGACGCCTCAAGGATATGAGTATGAGGGT
GAACTTGCAAGGGGGGGCCTCACGTTGTCT|AAAGTTCCTTTTCGATGCCCCATCCCCTAC
GTCTTCACGCGAAGGCATACGCCGTGGACG|CGCCCGTAGTATTTCTCATGTCTTCACGCG
GATTATAACCTTGTCACGTCCGGGAGCGTT|GCCGTGCCGTTCATGTCTTCACGCGAAGGC
GTTACTAGGTTATTCATGTCATGTCTTCAC|CACCGCCGCAAGCTGGTGTTCAACACCACG
CTTAGCGCCGAAAACTATCATGTCTTCACG|GACGAGTCCCGACTGGCGTTACTAGGTTAT
ACGCCGTGCCGTTCATGTCTTCACGCGAAG|TTCACGCGAAGGCATACGCCGTGGCGAACG
CGCTCGTCCACTCCGTCATGTAAAATCCGA|TTCTAAATGCTATCCGCTAGACTGCCTGTG
CGCGGAGTCCCTGTGATGCCCGAGAGAAAC|AGTGTCAACGGTTAGGCTCACCCCAGGACT
ACGTCCGGGAGCGTTATCCTAGGGCTTTGC|TCTTCACGCGAAGGCATACGCCGTGCATGT
ACGCCGTGTCATGTCTTCACGCGAAGGCAT|CGCCCCCAGGCTAGGCGTGGACGCTCGTCC
TGTTCAACACCACGCTGGCTCATGTCTTCA|CGTGTCATGTCTTCACGCGAAGGCATACGC
AGTAGCGCCCCCAGGCTAGGCGTGGACGCT|CACAGGTGGTCCGGCTGCGTGGTCCATTCT
GGCATACGCCGTGATTCGGTCTCACGGTGA|CCGTGCCTGGATTATCATGTCTTCACGCGA
TTAGCGCCGAAAACTATCATGTCTTCACGC|ACGAGTCCCGACTGGCGTTACTAGGTTATT
TCACGCGAAGGCATACGCCGTGCACCGACC|GCGAAGGCATACGCCGTGAGATTATAACCT
CATACCTTACCGCGGAGTCCCTGTGATGCC|GTAAAATCCGAGTGTCAACGGTTAGGCTCA
CTTGAACCATCGATGGGACTTAGCGCCGAA|GGGGATAAGTCCCTAGGAGACGAGTCCCGA
ATTCGGTCTCACGGTGATCCTAGAAGGCCT|ATCATGTCTTCACGCGAAGGCATACGCCGT
TTCGATGCCCCATCCCCTACTATCACAGGT|TGGGACGCCTCAAGGATATGAGTATGAGGG
CTCACTATTGGCACAAAGTTCCTTTTCGAT|GCCTGAAGGCTTGTATACTAATACTGGGAC
CAACCGGTGCCAATTGACTCTAGTTCCTCA|GGCATACGCCGTGGACGATCGAGTCATGTC
TCATGTCTTCACGCGAAGGCATACGCCGTG|GTCTTCACGCGAAGGCATACGCCGTGAGAT
GATTAGGGTTGAAACGTCATGTCTTCACGC|GTGCACCGACCATTGCCAATATGGACGAAA
TCAAACTTAGTTTCGTTCGGGTGTAGATGC|GAAGGCATACGCCGTGGTGGTTTTGGAGGC
CTTCACGCGAAGGCATACGCCGTGTTCATA|GCGTGGACGCTCGTCCACTCCGTCATGTAA
TTATCAGTATGCGCGTGCCTGTCATGTCTT|GCTTTGCTCTCGCACAACGCGGGCTCGCCC
GTCTTCACGCGAAGGCATACGCCGTGCCTG|CATACGCCGTGTTCATACCTTACCGCGGAG
CGGTTAGGCTCACCCCAGGACTCACTATTG|CTCCATGTGAACTAGGCACTGCCTGAAGGC
TCACGCGAAGGCATACGCCGTGCCTGGATT|CGCCGTGTTCATACCTTACCGCGGAGTCCC
ACTCTAGTTCCTCATGTCTTCACGCGAAGG|GATCGAGTCATGTCTTCACGCGAAGGCATA
CTGGCGTTACTAGGTTATTCATGTCATGTC|CCTAGCACCGCCGCAAGCTGGTGTTCAACA
TCACGCGAAGGCATACGCCGTGCCGTTCAT|AAAACTATCATGTCTTCACGCGAAGGCATA
AGTCCTAGCACCGCCGCAAGCTGGTGTTCA|ATGTCTTCACGCGAAGGCATACGCCGTGTC
TAGTAAAGTCCTAGCACCGCCGCAAGCTGG|CCTCTCATGTCTTCACGCGAAGGCATACGC
GGAGACGAGTCCCGACTGGCGTTACTAGGT|CTGGCTTAGTAAAGTCCTAGCACCGCCGCA
CATGAGCGATCAAGGGCCTATACGGTGCCA|CTTCACGCGAAGGCATACGCCGTGATTCGG
CCCCATCCCCTACTATCACAGGTGGTCCGG|CCTCAAGGATATGAGTATGAGGGTATAAGT
CGTGTCATGTCTTCACGCGAAGGCATACGC|CCCAGGCTAGGCGTGGACGCTCGTCCACTC
TTATACCGCTTGAACCATCGATGGGACTTA|GATCACACGGGGATAAGTCCCTAGGAGACG
AAGAAATTTGTACCAATTTTCCCTAAACTA|GCCAATTGACTCTAGTTCCTCATGTCTTCA
GCACCGCCGCAAGCTGGTGTTCAACACCAC|CACGCGAAGGCATACGCCGTGTCATGTCTT
TTTCAAACTTAGTTTCGTTCGGGTGTAGAT|GCGAAGGCATACGCCGTGGTGGTTTTGGAG
GTGTCATGTCTTCACGCGAAGGCATACGCC|CCAGGCTAGGCGTGGACGCTCGTCCACTCC
ACGGTTAGGCTCACCCCAGGACTCACTATT|GCTCCATGTGAACTAGGCACTGCCTGAAGG
TAGATGCTAAAAATCTGGGTAGTTAGCTTT|TGGAGGCCTCTCGTCCAATTTCACAACCGG
GCCTCACGTTGTCTGCCAGTAGCGCCCCCA|GCCCCATCCCCTACTATCACAGGTGGTCCG
CGTAGTATTTCTCATGTCTTCACGCGAAGG|TGCGTGTGCTTTTATACCGCTTGAACCATC
AACTTAGTTTCGTTCGGGTGTAGATGCTAA|GGCATACGCCGTGGTGGTTTTGGAGGCCTC
AGATGCTAAAAATCTGGGTAGTTAGCTTTT|GGAGGCCTCTCGTCCAATTTCACAACCGGT
TTATCCTAGGGCTTTGCTCTCGCACAACGC|GCATACGCCGTGCATGTCTTCACGCGAAGG
ACGCGAAGGCATACGCCGTGGACGATCGAG|TAGTATTTCTCATGTCTTCACGCGAAGGCA
TTTTATACCGCTTGAACCATCGATGGGACT|GCGATCACACGGGGATAAGTCCCTAGGAGA
TGGCTCATGTCTTCACGCGAAGGCATACGC|CGCGAAGGCATACGCCGTGTTCATACCTTA
TGCACCGACCATTGCCAATATGGACGAAAA|ATTATAACCTTGTCACGTCCGGGAGCGTTA
GCTCGTCCACTCCGTCATGTAAAATCCGAG|TCTAAATGCTATCCGCTAGACTGCCTGTGG
TTCACGCGAAGGCATACGCCGTGGACGATC|CCGTAGTATTTCTCATGTCTTCACGCGAAG
ACTTAGCGCCGAAAACTATCATGTCTTCAC|AGACGAGTCCCGACTGGCGTTACTAGGTTA
GGACGCTCGTCCACTCCGTCATGTAAAATC|CCATTCTAAATGCTATCCGCTAGACTGCCT
GGTGCCAATTGACTCTAGTTCCTCATGTCT|ACGCCGTGGACGATCGAGTCATGTCTTCAC
CACGCGAAGGCATACGCCGTGGTGGTTTTG|CGAAAAAAGTCACTTATCAGTATGCGCGTG
CTTCACGCGAAGGCATACGCCGTGGCGAAC|AGGTTATTCATGTCATGTCTTCACGCGAAG
GCTTTTAAGAAATTTGTACCAATTTTCCCT|ACCGGTGCCAATTGACTCTAGTTCCTCATG
CTCATGTCTTCACGCGAAGGCATACGCCGT|GGCCTCACGTTGTCTGCCAGTAGCGCCCCC
AGGCATACGCCGTGAGATTATAACCTTGTC|CACGCGAAGGCATACGCCGTGCCGTTCATG
CGGACGATGTTACGCATGAGCGATCAAGGG|GGCATACGCCGTGTCTTCACGCGAAGGCAT
GGCACAAAGTTCCTTTTCGATGCCCCATCC|CTTGTATACTAATACTGGGACGCCTCAAGG
TGTTACGCATGAGCGATCAAGGGCCTATAC|GCCGTGTCTTCACGCGAAGGCATACGCCGT
GCAAGCTGGTGTTCAACACCACGCTGGCTC|GGCATACGCCGTGTCATGTCTTCACGCGAA
AAGGCCTGTTCAAGCTGGCTTAGTAAAGTC|ACGCCGTGTTGACCGGGTGCCCTCTCATGT
GTGATCCTAGAAGGCCTGTTCAAGCTGGCT|GCGAAGGCATACGCCGTGTTGACCGGGTGC
CTTTTAAGAAATTTGTACCAATTTTCCCTA|CCGGTGCCAATTGACTCTAGTTCCTCATGT
GAGAGCGATCACACGGGGATAAGTCCCTAG|TCACGGTGATCCTAGAAGGCCTGTTCAAGC
TTATCATGTCTTCACGCGAAGGCATACGCC|CCTGTGATGCCCGAGAGAAACGCGTATGAC
TTCCTCATGTCTTCACGCGAAGGCATACGC|TCATGTCTTCACGCGAAGGCATACGCCGTG
CGTGTGCTTTTATACCGCTTGAACCATCGA|ATTGAGAGCGATCACACGGGGATAAGTCCC
TTCCCTAAACTATTGGCCTTGCGCCCAAGA|CTCATGTCTTCACGCGAAGGCATACGCCGT
TCCTCATGTCTTCACGCGAAGGCATACGCC|CATGTCTTCACGCGAAGGCATACGCCGTGA
CGACTGGCGTTACTAGGTTATTCATGTCAT|AGTCCTAGCACCGCCGCAAGCTGGTGTTCA
GAAAAAAGTCACTTATCAGTATGCGCGTGC|CGTTATCCTAGGGCTTTGCTCTCGCACAAC
GACGATGTTACGCATGAGCGATCAAGGGCC|CATACGCCGTGTCTTCACGCGAAGGCATAC
AGGCATACGCCGTGGCGAACGGACGATGTT|TGTCATGTCTTCACGCGAAGGCATACGCCG
GGAGCGTTATCCTAGGGCTTTGCTCTCGCA|GCGAAGGCATACGCCGTGCATGTCTTCACG
GTCTTCACGCGAAGGCATACGCCGTGCACC|TCACGCGAAGGCATACGCCGTGAGATTATA
ATTGAGAGCGATCACACGGGGATAAGTCCC|GTCTCACGGTGATCCTAGAAGGCCTGTTCA
GCCCGAGAGAAACGCGTATGACGGTGAACT|TCACCCCAGGACTCACTATTGGCACAAAGT
TGCTCTCGCACAACGCGGGCTCGCCCGTAG|TGTCTTCACGCGAAGGCATACGCCGTGCGT
GGCATACGCCGTGTTCATACCTTACCGCGG|CGTCCACTCCGTCATGTAAAATCCGAGTGT
TCATGTCTTCACGCGAAGGCATACGCCGTG|CAATATGGACGAAAAAAGTCACTTATCAGT
TTACGCATGAGCGATCAAGGGCCTATACGG|CGTGTCTTCACGCGAAGGCATACGCCGTGA
ATACGCCGTGTTGACCGGGTGCCCTCTCAT|GTATGACGGTGAACTTGCAAGGGGGGGCCT
TCACGCGAAGGCATACGCCGTGCGTGTGCT|GATCAAGGGCCTATACGGTGCCATTGAGAG
TCTGCCAGTAGCGCCCCCAGGCTAGGCGTG|TACTATCACAGGTGGTCCGGCTGCGTGGTC
TGGGTAGTTAGCTTTTAAGAAATTTGTACC|CAATTTCACAACCGGTGCCAATTGACTCTA
CGACCATTGCCAATATGGACGAAAAAAGTC|AACCTTGTCACGTCCGGGAGCGTTATCCTA
TAGGAGACGAGTCCCGACTGGCGTTACTAG|AGCTGGCTTAGTAAAGTCCTAGCACCGCCG
CATACGCCGTGGCGAACGGACGATGTTACG|CATGTCTTCACGCGAAGGCATACGCCGTGT
GTGGCGAACGGACGATGTTACGCATGAGCG|CACGCGAAGGCATACGCCGTGTCTTCACGC
CGCAAGCTGGTGTTCAACACCACGCTGGCT|AGGCATACGCCGTGTCATGTCTTCACGCGA
GACGAAAAAAGTCACTTATCAGTATGCGCG|GAGCGTTATCCTAGGGCTTTGCTCTCGCAC
CTCTCATGTCTTCACGCGAAGGCATACGCC|GGGGCCTCACGTTGTCTGCCAGTAGCGCCC
ATACGCCGTGATTCGGTCTCACGGTGATCC|TGCCTGGATTATCATGTCTTCACGCGAAGG
TAAGAAATTTGTACCAATTTTCCCTAAACT|TGCCAATTGACTCTAGTTCCTCATGTCTTC
GCATACGCCGTGTCATGTCTTCACGCGAAG|GTAGCGCCCCCAGGCTAGGCGTGGACGCTC
CGCCGAAAACTATCATGTCTTCACGCGAAG|GTCCCGACTGGCGTTACTAGGTTATTCATG
CGAAGGCATACGCCGTGCACCGACCATTGC|GGCATACGCCGTGAGATTATAACCTTGTCA
GCATACGCCGTGGCGAACGGACGATGTTAC|TCATGTCTTCACGCGAAGGCATACGCCGTG
TCATGTAAAATCCGAGTGTCAACGGTTAGG|GCTAGACTGCCTGTGGGACCTGCTCCATGT
CTGGTGTTCAACACCACGCTGGCTCATGTC|ACGCCGTGTCATGTCTTCACGCGAAGGCAT
GCGTGCCTGTCATGTCTTCACGCGAAGGCA|CACAACGCGGGCTCGCCCGTAGTATTTCTC
CCGGGAGCGTTATCCTAGGGCTTTGCTCTC|CACGCGAAGGCATACGCCGTGCATGTCTTC
ATCCTAGGGCTTTGCTCTCGCACAACGCGG|ATACGCCGTGCATGTCTTCACGCGAAGGCA
TAGGTTATTCATGTCATGTCTTCACGCGAA|CCGCAAGCTGGTGTTCAACACCACGCTGGC
GAACGGACGATGTTACGCATGAGCGATCAA|GAAGGCATACGCCGTGTCTTCACGCGAAGG
AAAAGTCACTTATCAGTATGCGCGTGCCTG|TATCCTAGGGCTTTGCTCTCGCACAACGCG
TTGACTCTAGTTCCTCATGTCTTCACGCGA|GACGATCGAGTCATGTCTTCACGCGAAGGC
CCCAGGCTAGGCGTGGACGCTCGTCCACTC|TCCGGCTGCGTGGTCCATTCTAAATGCTAT
TACGCCGTGAGATTATAACCTTGTCACGTC|GAAGGCATACGCCGTGCCGTTCATGTCTTC
AAACGCGTATGACGGTGAACTTGCAAGGGG|GACTCACTATTGGCACAAAGTTCCTTTTCG
GTTCAAGCTGGCTTAGTAAAGTCCTAGCAC|GTTGACCGGGTGCCCTCTCATGTCTTCACG
GGGGCCTCACGTTGTCTGCCAGTAGCGCCC|GATGCCCCATCCCCTACTATCACAGGTGGT
CCAAGATTAGGGTTGAAACGTCATGTCTTC|CGCCGTGCACCGACCATTGCCAATATGGAC
CCCGAGAGAAACGCGTATGACGGTGAACTT|CACCCCAGGACTCACTATTGGCACAAAGTT
CCGTGCGTGTGCTTTTATACCGCTTGAACC|GTGCCATTGAGAGCGATCACACGGGGATAA
TTCACGCGAAGGCATACGCCGTGTCATGTC|GTTGTCTGCCAGTAGCGCCCCCAGGCTAGG
CGTTATCCTAGGGCTTTGCTCTCGCACAAC|AGGCATACGCCGTGCATGTCTTCACGCGAA
TGTTCATACCTTACCGCGGAGTCCCTGTGA|TCATGTAAAATCCGAGTGTCAACGGTTAGG
TGAACCATCGATGGGACTTAGCGCCGAAAA|GGATAAGTCCCTAGGAGACGAGTCCCGACT
AAAGTCCTAGCACCGCCGCAAGCTGGTGTT|TCATGTCTTCACGCGAAGGCATACGCCGTG
AGGGCCTATACGGTGCCATTGAGAGCGATC|GCATACGCCGTGATTCGGTCTCACGGTGAT
GCCGTGCATGTCTTCACGCGAAGGCATACG|GTTACGCATGAGCGATCAAGGGCCTATACG
TACGCCGTGTTGACCGGGTGCCCTCTCATG|TATGACGGTGAACTTGCAAGGGGGGGCCTC
CGCATGAGCGATCAAGGGCCTATACGGTGC|GTCTTCACGCGAAGGCATACGCCGTGATTC
GCGCCCAAGATTAGGGTTGAAACGTCATGT|CATACGCCGTGCACCGACCATTGCCAATAT
GATGGGACTTAGCGCCGAAAACTATCATGT|CCTAGGAGACGAGTCCCGACTGGCGTTACT
CTTCACGCGAAGGCATACGCCGTGCACCGA|ACGCGAAGGCATACGCCGTGAGATTATAAC
CCGTCATGTAAAATCCGAGTGTCAACGGTT|TCCGCTAGACTGCCTGTGGGACCTGCTCCA
CCGTGCCGTTCATGTCTTCACGCGAAGGCA|ACGCGAAGGCATACGCCGTGGCGAACGGAC
CATTGAGAGCGATCACACGGGGATAAGTCC|GGTCTCACGGTGATCCTAGAAGGCCTGTTC
CACGGGGATAAGTCCCTAGGAGACGAGTCC|CTAGAAGGCCTGTTCAAGCTGGCTTAGTAA
ACGGTGAACTTGCAAGGGGGGGCCTCACGT|GGCACAAAGTTCCTTTTCGATGCCCCATCC
CGCCGTGCCTGGATTATCATGTCTTCACGC|TTACCGCGGAGTCCCTGTGATGCCCGAGAG
AATTTGTACCAATTTTCCCTAAACTATTGG|ATTGACTCTAGTTCCTCATGTCTTCACGCG
GCCGTGGCGAACGGACGATGTTACGCATGA|CTTCACGCGAAGGCATACGCCGTGTCTTCA
TGCCAGTAGCGCCCCCAGGCTAGGCGTGGA|CTATCACAGGTGGTCCGGCTGCGTGGTCCA
CCAATTTCACAACCGGTGCCAATTGACTCT|TCACGCGAAGGCATACGCCGTGGACGATCG
CAATATGGACGAAAAAAGTCACTTATCAGT|CGTCCGGGAGCGTTATCCTAGGGCTTTGCT
CGTGATTCGGTCTCACGGTGATCCTAGAAG|GATTATCATGTCTTCACGCGAAGGCATACG
GCATGAGCGATCAAGGGCCTATACGGTGCC|TCTTCACGCGAAGGCATACGCCGTGATTCG
CGCGAAGGCATACGCCGTGGACGATCGAGT|AGTATTTCTCATGTCTTCACGCGAAGGCAT
TCCCTAGGAGACGAGTCCCGACTGGCGTTA|TTCAAGCTGGCTTAGTAAAGTCCTAGCACC
GTCCCTAGGAGACGAGTCCCGACTGGCGTT|GTTCAAGCTGGCTTAGTAAAGTCCTAGCAC
CCGTGGTGGTTTTGGAGGCCTCTCGTCCAA|TCAGTATGCGCGTGCCTGTCATGTCTTCAC
GACGGTGAACTTGCAAGGGGGGGCCTCACG|TGGCACAAAGTTCCTTTTCGATGCCCCATC
CCTTGCGCCCAAGATTAGGGTTGAAACGTC|AAGGCATACGCCGTGCACCGACCATTGCCA
CCCATCCCCTACTATCACAGGTGGTCCGGC|CTCAAGGATATGAGTATGAGGGTATAAGTA
TACGCCGTGGACGATCGAGTCATGTCTTCA|ATGTCTTCACGCGAAGGCATACGCCGTGAT
CTGGGTAGTTAGCTTTTAAGAAATTTGTAC|CCAATTTCACAACCGGTGCCAATTGACTCT
CGGTGCCAATTGACTCTAGTTCCTCATGTC|TACGCCGTGGACGATCGAGTCATGTCTTCA
CATACGCCGTGTTGACCGGGTGCCCTCTCA|CGTATGACGGTGAACTTGCAAGGGGGGGCC
GTCCGGGAGCGTTATCCTAGGGCTTTGCTC|TTCACGCGAAGGCATACGCCGTGCATGTCT
ATGCTAAAAATCTGGGTAGTTAGCTTTTAA|AGGCCTCTCGTCCAATTTCACAACCGGTGC
CGCCGTGCACCGACCATTGCCAATATGGAC|GTGAGATTATAACCTTGTCACGTCCGGGAG
GTGTCTTCACGCGAAGGCATACGCCGTGAT|ACGCGAAGGCATACGCCGTGCCTGGATTAT
AGGTTATTCATGTCATGTCTTCACGCGAAG|CGCAAGCTGGTGTTCAACACCACGCTGGCT
CACGCGAAGGCATACGCCGTGATGTCTTCA|TTGAACCATCGATGGGACTTAGCGCCGAAA
CCTCTCGTCCAATTTCACAACCGGTGCCAA|TCATGTCTTCACGCGAAGGCATACGCCGTG
ATGTCATGTCTTCACGCGAAGGCATACGCC|GTGTTCAACACCACGCTGGCTCATGTCTTC
ACAAATTTCAAACTTAGTTTCGTTCGGGTG|TTCACGCGAAGGCATACGCCGTGGTGGTTT
GATGCCCGAGAGAAACGCGTATGACGGTGA|GGCTCACCCCAGGACTCACTATTGGCACAA
CGCGAAGGCATACGCCGTGTCATGTCTTCA|TCTGCCAGTAGCGCCCCCAGGCTAGGCGTG
CATACGCCGTGGTGGTTTTGGAGGCCTCTC|CACTTATCAGTATGCGCGTGCCTGTCATGT
TCCAATTTCACAACCGGTGCCAATTGACTC|TTCACGCGAAGGCATACGCCGTGGACGATC
GGACGATCGAGTCATGTCTTCACGCGAAGG|ACGCGAAGGCATACGCCGTGATGTCTTCAC
TTCACGCGAAGGCATACGCCGTGATTCGGT|AAGGCATACGCCGTGCCTGGATTATCATGT
AAGTTCCTTTTCGATGCCCCATCCCCTACT|TACTAATACTGGGACGCCTCAAGGATATGA
TCCGTCATGTAAAATCCGAGTGTCAACGGT|ATCCGCTAGACTGCCTGTGGGACCTGCTCC
GGCTTAGTAAAGTCCTAGCACCGCCGCAAG|GTGCCCTCTCATGTCTTCACGCGAAGGCAT
ATGTCTTCACGCGAAGGCATACGCCGTGAG|CGCCGTGATGTCTTCACGCGAAGGCATACG
CCGCAAGCTGGTGTTCAACACCACGCTGGC|AAGGCATACGCCGTGTCATGTCTTCACGCG
ATTGGCACAAAGTTCCTTTTCGATGCCCCA|AGGCTTGTATACTAATACTGGGACGCCTCA
AACGGACGATGTTACGCATGAGCGATCAAG|AAGGCATACGCCGTGTCTTCACGCGAAGGC
GCACAACGCGGGCTCGCCCGTAGTATTTCT|ACGCGAAGGCATACGCCGTGCGTGTGCTTT
CTTCACGCGAAGGCATACGCCGTGCCTGGA|TACGCCGTGTTCATACCTTACCGCGGAGTC
CCCTAAACTATTGGCCTTGCGCCCAAGATT|CATGTCTTCACGCGAAGGCATACGCCGTGC
CCGGTGCCAATTGACTCTAGTTCCTCATGT|ATACGCCGTGGACGATCGAGTCATGTCTTC
CGCCGTGCATGTCTTCACGCGAAGGCATAC|TGTTACGCATGAGCGATCAAGGGCCTATAC
ATACGCCGTGTCTTCACGCGAAGGCATACG|TGTCTTCACGCGAAGGCATACGCCGTGCCT
CCTAGCACCGCCGCAAGCTGGTGTTCAACA|TCTTCACGCGAAGGCATACGCCGTGTCATG
GTGTAGATGCTAAAAATCTGGGTAGTTAGC|TTTTGGAGGCCTCTCGTCCAATTTCACAAC
GTGGTGGTTTTGGAGGCCTCTCGTCCAATT|AGTATGCGCGTGCCTGTCATGTCTTCACGC
GCTGGCTCATGTCTTCACGCGAAGGCATAC|CACGCGAAGGCATACGCCGTGTTCATACCT
ATACGCCGTGGACGATCGAGTCATGTCTTC|CATGTCTTCACGCGAAGGCATACGCCGTGA
TCACGCGAAGGCATACGCCGTGTCTTCACG|CACGCTGGCTCATGTCTTCACGCGAAGGCA
AAGGCATACGCCGTGATGTCTTCACGCGAA|CATCGATGGGACTTAGCGCCGAAAACTATC
CACGGTGATCCTAGAAGGCCTGTTCAAGCT|TCACGCGAAGGCATACGCCGTGTTGACCGG
CCTGTGATGCCCGAGAGAAACGCGTATGAC|GGTTAGGCTCACCCCAGGACTCACTATTGG
CGTCATGTCTTCACGCGAAGGCATACGCCG|GCCAATATGGACGAAAAAAGTCACTTATCA
TGTAAAATCCGAGTGTCAACGGTTAGGCTC|AGACTGCCTGTGGGACCTGCTCCATGTGAA
ATACGCCGTGGCGAACGGACGATGTTACGC|ATGTCTTCACGCGAAGGCATACGCCGTGTC
GTTCGGGTGTAGATGCTAAAAATCTGGGTA|TGGTGGTTTTGGAGGCCTCTCGTCCAATTT
TTGAACCATCGATGGGACTTAGCGCCGAAA|GGGATAAGTCCCTAGGAGACGAGTCCCGAC
TTGCCAATATGGACGAAAAAAGTCACTTAT|GTCACGTCCGGGAGCGTTATCCTAGGGCTT
CGCCGTGTTCATACCTTACCGCGGAGTCCC|CTCCGTCATGTAAAATCCGAGTGTCAACGG
CCTTACCGCGGAGTCCCTGTGATGCCCGAG|AATCCGAGTGTCAACGGTTAGGCTCACCCC
GGCTCACCCCAGGACTCACTATTGGCACAA|GTGAACTAGGCACTGCCTGAAGGCTTGTAT
AAGGCATACGCCGTGTCATGTCTTCACGCG|CCAGTAGCGCCCCCAGGCTAGGCGTGGACG
ATTTCTCATGTCTTCACGCGAAGGCATACG|TGCTTTTATACCGCTTGAACCATCGATGGG
ACCATTGCCAATATGGACGAAAAAAGTCAC|CCTTGTCACGTCCGGGAGCGTTATCCTAGG
GTGTGCTTTTATACCGCTTGAACCATCGAT|TTGAGAGCGATCACACGGGGATAAGTCCCT
CATGTCTTCACGCGAAGGCATACGCCGTGA|ACGCCGTGATGTCTTCACGCGAAGGCATAC
AGGTGGTCCGGCTGCGTGGTCCATTCTAAA|AGGGTATAAGTAACAAGCCCGGGAAAACGG
GTTACGCATGAGCGATCAAGGGCCTATACG|CCGTGTCTTCACGCGAAGGCATACGCCGTG
TTAAGAAATTTGTACCAATTTTCCCTAAAC|GTGCCAATTGACTCTAGTTCCTCATGTCTT
GCCGCAAGCTGGTGTTCAACACCACGCTGG|GAAGGCATACGCCGTGTCATGTCTTCACGC
CGCGAAGGCATACGCCGTGATTCGGTCTCA|CATACGCCGTGCCTGGATTATCATGTCTTC
GCTAAAAATCTGGGTAGTTAGCTTTTAAGA|GCCTCTCGTCCAATTTCACAACCGGTGCCA
GTCATGTAAAATCCGAGTGTCAACGGTTAG|CGCTAGACTGCCTGTGGGACCTGCTCCATG
TTGCTCTCGCACAACGCGGGCTCGCCCGTA|ATGTCTTCACGCGAAGGCATACGCCGTGCG
GTCATGTCTTCACGCGAAGGCATACGCCGT|AGGCTAGGCGTGGACGCTCGTCCACTCCGT
CATGTCTTCACGCGAAGGCATACGCCGTGT|TGATGCCCGAGAGAAACGCGTATGACGGTG
TGTCTTCACGCGAAGGCATACGCCGTGAGA|GCCGTGATGTCTTCACGCGAAGGCATACGC
CCAATTGACTCTAGTTCCTCATGTCTTCAC|CGTGGACGATCGAGTCATGTCTTCACGCGA
TCACGCGAAGGCATACGCCGTGGTGGTTTT|ACGAAAAAAGTCACTTATCAGTATGCGCGT
GAGACGAGTCCCGACTGGCGTTACTAGGTT|TGGCTTAGTAAAGTCCTAGCACCGCCGCAA
TTCGTTCGGGTGTAGATGCTAAAAATCTGG|CCGTGGTGGTTTTGGAGGCCTCTCGTCCAA
TAAAATCCGAGTGTCAACGGTTAGGCTCAC|ACTGCCTGTGGGACCTGCTCCATGTGAACT
ACGCGAAGGCATACGCCGTGTTGACCGGGT|AGAGAAACGCGTATGACGGTGAACTTGCAA
CCGAAAACTATCATGTCTTCACGCGAAGGC|CCCGACTGGCGTTACTAGGTTATTCATGTC
GCATACGCCGTGTCTTCACGCGAAGGCATA|CATGTCTTCACGCGAAGGCATACGCCGTGC
ACTTGCAAGGGGGGGCCTCACGTTGTCTGC|AGTTCCTTTTCGATGCCCCATCCCCTACTA
GCGAAGGCATACGCCGTGCACCGACCATTG|AGGCATACGCCGTGAGATTATAACCTTGTC
TCGTTCGGGTGTAGATGCTAAAAATCTGGG|CGTGGTGGTTTTGGAGGCCTCTCGTCCAAT
CTCGTCCACTCCGTCATGTAAAATCCGAGT|CTAAATGCTATCCGCTAGACTGCCTGTGGG
CTGCCAGTAGCGCCCCCAGGCTAGGCGTGG|ACTATCACAGGTGGTCCGGCTGCGTGGTCC
TTATTCATGTCATGTCTTCACGCGAAGGCA|AAGCTGGTGTTCAACACCACGCTGGCTCAT
GCCTATACGGTGCCATTGAGAGCGATCACA|TACGCCGTGATTCGGTCTCACGGTGATCCT
TCGAGTCATGTCTTCACGCGAAGGCATACG|AGGCATACGCCGTGATGTCTTCACGCGAAG
TTTTAAGAAATTTGTACCAATTTTCCCTAA|CGGTGCCAATTGACTCTAGTTCCTCATGTC
CACGCGAAGGCATACGCCGTGCCGTTCATG|AAACTATCATGTCTTCACGCGAAGGCATAC
CCGTGTTCATACCTTACCGCGGAGTCCCTG|CCGTCATGTAAAATCCGAGTGTCAACGGTT
CAAACTTAGTTTCGTTCGGGTGTAGATGCT|AAGGCATACGCCGTGGTGGTTTTGGAGGCC
CGAGTGTCAACGGTTAGGCTCACCCCAGGA|GTGGGACCTGCTCCATGTGAACTAGGCACT
GTCTTCACGCGAAGGCATACGCCGTGATGT|ACCGCTTGAACCATCGATGGGACTTAGCGC
CCGCTTGAACCATCGATGGGACTTAGCGCC|CACGGGGATAAGTCCCTAGGAGACGAGTCC
TTCTCATGTCTTCACGCGAAGGCATACGCC|CTTTTATACCGCTTGAACCATCGATGGGAC
ATGTCTTCACGCGAAGGCATACGCCGTGCC|GCGCCGAAAACTATCATGTCTTCACGCGAA
ATACGCCGTGCCTGGATTATCATGTCTTCA|ACCTTACCGCGGAGTCCCTGTGATGCCCGA
TGTCTTCACGCGAAGGCATACGCCGTGTTC|TAGGCGTGGACGCTCGTCCACTCCGTCATG
TCACACGGGGATAAGTCCCTAGGAGACGAG|ATCCTAGAAGGCCTGTTCAAGCTGGCTTAG
GGCATACGCCGTGCATGTCTTCACGCGAAG|GGACGATGTTACGCATGAGCGATCAAGGGC
GCATACGCCGTGCACCGACCATTGCCAATA|ACGCCGTGAGATTATAACCTTGTCACGTCC
ATACGCCGTGGTGGTTTTGGAGGCCTCTCG|ACTTATCAGTATGCGCGTGCCTGTCATGTC
CCGTGTTGACCGGGTGCCCTCTCATGTCTT|ACGGTGAACTTGCAAGGGGGGGCCTCACGT
AGGGTTGAAACGTCATGTCTTCACGCGAAG|ACCGACCATTGCCAATATGGACGAAAAAAG
CGTGGACGATCGAGTCATGTCTTCACGCGA|TTCACGCGAAGGCATACGCCGTGATGTCTT
TTTTCGATGCCCCATCCCCTACTATCACAG|ACTGGGACGCCTCAAGGATATGAGTATGAG
CCGTGTCTTCACGCGAAGGCATACGCCGTG|TCACGCGAAGGCATACGCCGTGCCTGGATT
GCATACGCCGTGGTGGTTTTGGAGGCCTCT|TCACTTATCAGTATGCGCGTGCCTGTCATG
TCCTTTTCGATGCCCCATCCCCTACTATCA|AATACTGGGACGCCTCAAGGATATGAGTAT
CAGTATGCGCGTGCCTGTCATGTCTTCACG|TGCTCTCGCACAACGCGGGCTCGCCCGTAG
CCAATATGGACGAAAAAAGTCACTTATCAG|ACGTCCGGGAGCGTTATCCTAGGGCTTTGC
ATGCCCCATCCCCTACTATCACAGGTGGTC|ACGCCTCAAGGATATGAGTATGAGGGTATA
CGGTGAACTTGCAAGGGGGGGCCTCACGTT|GCACAAAGTTCCTTTTCGATGCCCCATCCC
GTAAAGTCCTAGCACCGCCGCAAGCTGGTG|TCTCATGTCTTCACGCGAAGGCATACGCCG
ACGGACGATGTTACGCATGAGCGATCAAGG|AGGCATACGCCGTGTCTTCACGCGAAGGCA
TCACGCGAAGGCATACGCCGTGTTGACCGG|CGAGAGAAACGCGTATGACGGTGAACTTGC
TCACGCGAAGGCATACGCCGTGGCGAACGG|GTTATTCATGTCATGTCTTCACGCGAAGGC
AGCGCCGAAAACTATCATGTCTTCACGCGA|GAGTCCCGACTGGCGTTACTAGGTTATTCA
CCGTGTCATGTCTTCACGCGAAGGCATACG|CCCCAGGCTAGGCGTGGACGCTCGTCCACT
AATTTCACAACCGGTGCCAATTGACTCTAG|ACGCGAAGGCATACGCCGTGGACGATCGAG
GATGCCCCATCCCCTACTATCACAGGTGGT|GACGCCTCAAGGATATGAGTATGAGGGTAT
ACGATGTTACGCATGAGCGATCAAGGGCCT|ATACGCCGTGTCTTCACGCGAAGGCATACG
TTCACGCGAAGGCATACGCCGTGATGTCTT|GCTTGAACCATCGATGGGACTTAGCGCCGA
CATACGCCGTGTCATGTCTTCACGCGAAGG|TAGCGCCCCCAGGCTAGGCGTGGACGCTCG
TTCAAGCTGGCTTAGTAAAGTCCTAGCACC|TTGACCGGGTGCCCTCTCATGTCTTCACGC
ATCATGTCTTCACGCGAAGGCATACGCCGT|CGTTACTAGGTTATTCATGTCATGTCTTCA
ACGCCGTGGCGAACGGACGATGTTACGCAT|GTCTTCACGCGAAGGCATACGCCGTGTCTT
ACGCATGAGCGATCAAGGGCCTATACGGTG|TGTCTTCACGCGAAGGCATACGCCGTGATT
AGTTAGCTTTTAAGAAATTTGTACCAATTT|TCACAACCGGTGCCAATTGACTCTAGTTCC
AAGGCATACGCCGTGGCGAACGGACGATGT|ATGTCATGTCTTCACGCGAAGGCATACGCC
GCATACGCCGTGCATGTCTTCACGCGAAGG|GACGATGTTACGCATGAGCGATCAAGGGCC
GTGCGTGTGCTTTTATACCGCTTGAACCAT|GCCATTGAGAGCGATCACACGGGGATAAGT
ATACCTTACCGCGGAGTCCCTGTGATGCCC|TAAAATCCGAGTGTCAACGGTTAGGCTCAC
ACCTTGTCACGTCCGGGAGCGTTATCCTAG|CGTTCATGTCTTCACGCGAAGGCATACGCC
ACTCCGTCATGTAAAATCCGAGTGTCAACG|CTATCCGCTAGACTGCCTGTGGGACCTGCT
CCCTACTATCACAGGTGGTCCGGCTGCGTG|GATATGAGTATGAGGGTATAAGTAACAAGC
AAGGCATACGCCGTGCCGTTCATGTCTTCA|TCATGTCTTCACGCGAAGGCATACGCCGTG
TGTCTTCACGCGAAGGCATACGCCGTGGCG|ACTAGGTTATTCATGTCATGTCTTCACGCG
AAATTTCAAACTTAGTTTCGTTCGGGTGTA|CACGCGAAGGCATACGCCGTGGTGGTTTTG
CCTTGTCACGTCCGGGAGCGTTATCCTAGG|GTTCATGTCTTCACGCGAAGGCATACGCCG
GGCCTCTCGTCCAATTTCACAACCGGTGCC|TGTCATGTCTTCACGCGAAGGCATACGCCG
CCGTAGTATTTCTCATGTCTTCACGCGAAG|GTGCGTGTGCTTTTATACCGCTTGAACCAT
TGCGCCCAAGATTAGGGTTGAAACGTCATG|GCATACGCCGTGCACCGACCATTGCCAATA
GCGAAGGCATACGCCGTGTTGACCGGGTGC|AGAAACGCGTATGACGGTGAACTTGCAAGG
GAGAAACGCGTATGACGGTGAACTTGCAAG|CAGGACTCACTATTGGCACAAAGTTCCTTT
CTCGCCCGTAGTATTTCTCATGTCTTCACG|ACGCCGTGCGTGTGCTTTTATACCGCTTGA
CGTCCAATTTCACAACCGGTGCCAATTGAC|TCTTCACGCGAAGGCATACGCCGTGGACGA
TCGTCCAATTTCACAACCGGTGCCAATTGA|GTCTTCACGCGAAGGCATACGCCGTGGACG
GGCGTTACTAGGTTATTCATGTCATGTCTT|TAGCACCGCCGCAAGCTGGTGTTCAACACC
GGGACTTAGCGCCGAAAACTATCATGTCTT|AGGAGACGAGTCCCGACTGGCGTTACTAGG
CGCTGGCTCATGTCTTCACGCGAAGGCATA|TCACGCGAAGGCATACGCCGTGTTCATACC
ACAACGCGGGCTCGCCCGTAGTATTTCTCA|GCGAAGGCATACGCCGTGCGTGTGCTTTTA
CACGTTGTCTGCCAGTAGCGCCCCCAGGCT|CATCCCCTACTATCACAGGTGGTCCGGCTG
GTCCAATTTCACAACCGGTGCCAATTGACT|CTTCACGCGAAGGCATACGCCGTGGACGAT
AGGCATACGCCGTGGACGATCGAGTCATGT|TTCTCATGTCTTCACGCGAAGGCATACGCC
ACTATTGGCACAAAGTTCCTTTTCGATGCC|TGAAGGCTTGTATACTAATACTGGGACGCC
CATGTCTTCACGCGAAGGCATACGCCGTGG|TTACTAGGTTATTCATGTCATGTCTTCACG
ACGAGTCCCGACTGGCGTTACTAGGTTATT|CTTAGTAAAGTCCTAGCACCGCCGCAAGCT
GGCTCATGTCTTCACGCGAAGGCATACGCC|GCGAAGGCATACGCCGTGTTCATACCTTAC
GTTGTCTGCCAGTAGCGCCCCCAGGCTAGG|CCCCTACTATCACAGGTGGTCCGGCTGCGT
TCATGTCATGTCTTCACGCGAAGGCATACG|TGGTGTTCAACACCACGCTGGCTCATGTCT
TCGATGGGACTTAGCGCCGAAAACTATCAT|TCCCTAGGAGACGAGTCCCGACTGGCGTTA
ATGTCTTCACGCGAAGGCATACGCCGTGTT|CTAGGCGTGGACGCTCGTCCACTCCGTCAT
CGTGCCTGTCATGTCTTCACGCGAAGGCAT|ACAACGCGGGCTCGCCCGTAGTATTTCTCA
GCTGGCTTAGTAAAGTCCTAGCACCGCCGC|CGGGTGCCCTCTCATGTCTTCACGCGAAGG
CGATGTTACGCATGAGCGATCAAGGGCCTA|TACGCCGTGTCTTCACGCGAAGGCATACGC
CATACGCCGTGTTCATACCTTACCGCGGAG|TCCACTCCGTCATGTAAAATCCGAGTGTCA
GGACTCACTATTGGCACAAAGTTCCTTTTC|ACTGCCTGAAGGCTTGTATACTAATACTGG
GAAGGCATACGCCGTGTTCATACCTTACCG|GCTCGTCCACTCCGTCATGTAAAATCCGAG
TTTCGATGCCCCATCCCCTACTATCACAGG|CTGGGACGCCTCAAGGATATGAGTATGAGG
TGAGATTATAACCTTGTCACGTCCGGGAGC|TACGCCGTGCCGTTCATGTCTTCACGCGAA
ACTATCACAGGTGGTCCGGCTGCGTGGTCC|TGAGTATGAGGGTATAAGTAACAAGCCCGG
GCATGTCTTCACGCGAAGGCATACGCCGTG|GCATGAGCGATCAAGGGCCTATACGGTGCC
GCCGTGCCGTTCATGTCTTCACGCGAAGGC|CACGCGAAGGCATACGCCGTGGCGAACGGA
AACCTTGTCACGTCCGGGAGCGTTATCCTA|CCGTTCATGTCTTCACGCGAAGGCATACGC
GTGCTTTTATACCGCTTGAACCATCGATGG|GAGAGCGATCACACGGGGATAAGTCCCTAG
CTATCACAGGTGGTCCGGCTGCGTGGTCCA|GAGTATGAGGGTATAAGTAACAAGCCCGGG
ATTGGCCTTGCGCCCAAGATTAGGGTTGAA|ACGCGAAGGCATACGCCGTGCACCGACCAT
CTTCACGCGAAGGCATACGCCGTGAGATTA|GTGATGTCTTCACGCGAAGGCATACGCCGT
GGGTAGTTAGCTTTTAAGAAATTTGTACCA|AATTTCACAACCGGTGCCAATTGACTCTAG
ACTATTGGCCTTGCGCCCAAGATTAGGGTT|TTCACGCGAAGGCATACGCCGTGCACCGAC
GGTGGTCCGGCTGCGTGGTCCATTCTAAAT|GGGTATAAGTAACAAGCCCGGGAAAACGGC
TGATGTCTTCACGCGAAGGCATACGCCGTG|TAGCGCCGAAAACTATCATGTCTTCACGCG
TGAGCGATCAAGGGCCTATACGGTGCCATT|TCACGCGAAGGCATACGCCGTGATTCGGTC
TCACGCGAAGGCATACGCCGTGTTCATACC|GTGGACGCTCGTCCACTCCGTCATGTAAAA
CGCCGTGAGATTATAACCTTGTCACGTCCG|AGGCATACGCCGTGCCGTTCATGTCTTCAC
CGGGTGTAGATGCTAAAAATCTGGGTAGTT|TGGTTTTGGAGGCCTCTCGTCCAATTTCAC
GCGAACGGACGATGTTACGCATGAGCGATC|GCGAAGGCATACGCCGTGTCTTCACGCGAA
TCTTCACGCGAAGGCATACGCCGTGTTGAC|GCCCGAGAGAAACGCGTATGACGGTGAACT
GCCTGGATTATCATGTCTTCACGCGAAGGC|CGGAGTCCCTGTGATGCCCGAGAGAAACGC
CGAAGGCATACGCCGTGATGTCTTCACGCG|ACCATCGATGGGACTTAGCGCCGAAAACTA
ATTATCATGTCTTCACGCGAAGGCATACGC|CCCTGTGATGCCCGAGAGAAACGCGTATGA
CTCTCGTCCAATTTCACAACCGGTGCCAAT|CATGTCTTCACGCGAAGGCATACGCCGTGG
ATGTCTTCACGCGAAGGCATACGCCGTGAT|ATACCGCTTGAACCATCGATGGGACTTAGC
TTGTCTGCCAGTAGCGCCCCCAGGCTAGGC|CCCTACTATCACAGGTGGTCCGGCTGCGTG
GCATACGCCGTGATGTCTTCACGCGAAGGC|CGATGGGACTTAGCGCCGAAAACTATCATG
CCTGTCATGTCTTCACGCGAAGGCATACGC|CGCGGGCTCGCCCGTAGTATTTCTCATGTC
CATTGCCAATATGGACGAAAAAAGTCACTT|TTGTCACGTCCGGGAGCGTTATCCTAGGGC
AGGCTAGGCGTGGACGCTCGTCCACTCCGT|GGCTGCGTGGTCCATTCTAAATGCTATCCG
GAAGGCATACGCCGTGCCTGGATTATCATG|GTTCATACCTTACCGCGGAGTCCCTGTGAT
ATACGCCGTGAGATTATAACCTTGTCACGT|CGAAGGCATACGCCGTGCCGTTCATGTCTT
CCGTGCCTGGATTATCATGTCTTCACGCGA|ACCGCGGAGTCCCTGTGATGCCCGAGAGAA
GAAGGCATACGCCGTGTCATGTCTTCACGC|GCCAGTAGCGCCCCCAGGCTAGGCGTGGAC
AGGCCTCTCGTCCAATTTCACAACCGGTGC|CTGTCATGTCTTCACGCGAAGGCATACGCC
GTGAGATTATAACCTTGTCACGTCCGGGAG|ATACGCCGTGCCGTTCATGTCTTCACGCGA
TCACGCGAAGGCATACGCCGTGATTCGGTC|AGGCATACGCCGTGCCTGGATTATCATGTC
GATCCTAGAAGGCCTGTTCAAGCTGGCTTA|GAAGGCATACGCCGTGTTGACCGGGTGCCC
CCACGCTGGCTCATGTCTTCACGCGAAGGC|TCTTCACGCGAAGGCATACGCCGTGTTCAT
CCCCAGGACTCACTATTGGCACAAAGTTCC|TAGGCACTGCCTGAAGGCTTGTATACTAAT
GCATACGCCGTGCCTGGATTATCATGTCTT|ATACCTTACCGCGGAGTCCCTGTGATGCCC
ACGCCGTGGACGATCGAGTCATGTCTTCAC|TGTCTTCACGCGAAGGCATACGCCGTGATG
ACGCGAAGGCATACGCCGTGCACCGACCAT|GAAGGCATACGCCGTGAGATTATAACCTTG
TTCACGCGAAGGCATACGCCGTGCACCGAC|CGCGAAGGCATACGCCGTGAGATTATAACC
CGGGAGCGTTATCCTAGGGCTTTGCTCTCG|ACGCGAAGGCATACGCCGTGCATGTCTTCA
TCACAACCGGTGCCAATTGACTCTAGTTCC|GAAGGCATACGCCGTGGACGATCGAGTCAT
GAAACGCGTATGACGGTGAACTTGCAAGGG|GGACTCACTATTGGCACAAAGTTCCTTTTC
AAGTCCCTAGGAGACGAGTCCCGACTGGCG|CTGTTCAAGCTGGCTTAGTAAAGTCCTAGC
TGATGCCCGAGAGAAACGCGTATGACGGTG|AGGCTCACCCCAGGACTCACTATTGGCACA
ACGCCGTGCATGTCTTCACGCGAAGGCATA|ATGTTACGCATGAGCGATCAAGGGCCTATA
CCTCACGTTGTCTGCCAGTAGCGCCCCCAG|CCCCATCCCCTACTATCACAGGTGGTCCGG
TGTCTTCACGCGAAGGCATACGCCGTGTCA|TCACGTTGTCTGCCAGTAGCGCCCCCAGGC
TGAGAGCGATCACACGGGGATAAGTCCCTA|CTCACGGTGATCCTAGAAGGCCTGTTCAAG
CAAGATTAGGGTTGAAACGTCATGTCTTCA|GCCGTGCACCGACCATTGCCAATATGGACG
AAAGTCACTTATCAGTATGCGCGTGCCTGT|ATCCTAGGGCTTTGCTCTCGCACAACGCGG
ACACCACGCTGGCTCATGTCTTCACGCGAA|ATGTCTTCACGCGAAGGCATACGCCGTGTT
AGTGTCAACGGTTAGGCTCACCCCAGGACT|GGGACCTGCTCCATGTGAACTAGGCACTGC
TGACGGTGAACTTGCAAGGGGGGGCCTCAC|TTGGCACAAAGTTCCTTTTCGATGCCCCAT
CACTTATCAGTATGCGCGTGCCTGTCATGT|AGGGCTTTGCTCTCGCACAACGCGGGCTCG
TTCACGCGAAGGCATACGCCGTGCCGTTCA|GAAAACTATCATGTCTTCACGCGAAGGCAT
AGGCATACGCCGTGTCTTCACGCGAAGGCA|CTCATGTCTTCACGCGAAGGCATACGCCGT
CGCGAAGGCATACGCCGTGCCTGGATTATC|CGTGTTCATACCTTACCGCGGAGTCCCTGT
CAGTAAACTCACAAATTTCAAACTTAGTTT|ACGTCATGTCTTCACGCGAAGGCATACGCC
TTATAACCTTGTCACGTCCGGGAGCGTTAT|CGTGCCGTTCATGTCTTCACGCGAAGGCAT
CAGGCTAGGCGTGGACGCTCGTCCACTCCG|CGGCTGCGTGGTCCATTCTAAATGCTATCC
GCGAAGGCATACGCCGTGATGTCTTCACGC|AACCATCGATGGGACTTAGCGCCGAAAACT
GCCGTGGACGATCGAGTCATGTCTTCACGC|TCTTCACGCGAAGGCATACGCCGTGATGTC
CGCGAAGGCATACGCCGTGCACCGACCATT|AAGGCATACGCCGTGAGATTATAACCTTGT
AGTTCCTTTTCGATGCCCCATCCCCTACTA|ACTAATACTGGGACGCCTCAAGGATATGAG
ACGCGAAGGCATACGCCGTGATTCGGTCTC|GCATACGCCGTGCCTGGATTATCATGTCTT
GCCTTGCGCCCAAGATTAGGGTTGAAACGT|GAAGGCATACGCCGTGCACCGACCATTGCC
TACGCCGTGATGTCTTCACGCGAAGGCATA|TGGGACTTAGCGCCGAAAACTATCATGTCT
CCGTGATTCGGTCTCACGGTGATCCTAGAA|GGATTATCATGTCTTCACGCGAAGGCATAC
GGTCTCACGGTGATCCTAGAAGGCCTGTTC|TGTCTTCACGCGAAGGCATACGCCGTGTTG
ATAAGTCCCTAGGAGACGAGTCCCGACTGG|GCCTGTTCAAGCTGGCTTAGTAAAGTCCTA
CGATGCCCCATCCCCTACTATCACAGGTGG|GGACGCCTCAAGGATATGAGTATGAGGGTA
CTCACGTTGTCTGCCAGTAGCGCCCCCAGG|CCCATCCCCTACTATCACAGGTGGTCCGGC
GCGGAGTCCCTGTGATGCCCGAGAGAAACG|GTGTCAACGGTTAGGCTCACCCCAGGACTC
CTGTGATGCCCGAGAGAAACGCGTATGACG|GTTAGGCTCACCCCAGGACTCACTATTGGC
ATAACCTTGTCACGTCCGGGAGCGTTATCC|TGCCGTTCATGTCTTCACGCGAAGGCATAC
CGCGAAGGCATACGCCGTGAGATTATAACC|GTCTTCACGCGAAGGCATACGCCGTGCCGT
CTTCACGCGAAGGCATACGCCGTGTCATGT|CGTTGTCTGCCAGTAGCGCCCCCAGGCTAG
GTCTTCACGCGAAGGCATACGCCGTGTTCA|AGGCGTGGACGCTCGTCCACTCCGTCATGT
AGGCATACGCCGTGCATGTCTTCACGCGAA|CGGACGATGTTACGCATGAGCGATCAAGGG
CGGTGATCCTAGAAGGCCTGTTCAAGCTGG|ACGCGAAGGCATACGCCGTGTTGACCGGGT
GCGAAGGCATACGCCGTGATTCGGTCTCAC|ATACGCCGTGCCTGGATTATCATGTCTTCA
ACGCCGTGATGTCTTCACGCGAAGGCATAC|GGGACTTAGCGCCGAAAACTATCATGTCTT
AATATGGACGAAAAAAGTCACTTATCAGTA|GTCCGGGAGCGTTATCCTAGGGCTTTGCTC
CTGTCATGTCTTCACGCGAAGGCATACGCC|GCGGGCTCGCCCGTAGTATTTCTCATGTCT
TGGATTATCATGTCTTCACGCGAAGGCATA|AGTCCCTGTGATGCCCGAGAGAAACGCGTA
GATGTTACGCATGAGCGATCAAGGGCCTAT|ACGCCGTGTCTTCACGCGAAGGCATACGCC
CATGTCTTCACGCGAAGGCATACGCCGTGC|ATACGCCGTGGCGAACGGACGATGTTACGC
ATGTCTTCACGCGAAGGCATACGCCGTGCA|TACGCCGTGGCGAACGGACGATGTTACGCA
GCCTGTTCAAGCTGGCTTAGTAAAGTCCTA|CCGTGTTGACCGGGTGCCCTCTCATGTCTT
CGAACGGACGATGTTACGCATGAGCGATCA|CGAAGGCATACGCCGTGTCTTCACGCGAAG
GGGTGCCCTCTCATGTCTTCACGCGAAGGC|GCAAGGGGGGGCCTCACGTTGTCTGCCAGT
ACCCCAGGACTCACTATTGGCACAAAGTTC|CTAGGCACTGCCTGAAGGCTTGTATACTAA
AGTCACTTATCAGTATGCGCGTGCCTGTCA|CCTAGGGCTTTGCTCTCGCACAACGCGGGC
TTCCTTTTCGATGCCCCATCCCCTACTATC|TAATACTGGGACGCCTCAAGGATATGAGTA
GCCCCATCCCCTACTATCACAGGTGGTCCG|GCCTCAAGGATATGAGTATGAGGGTATAAG
TGTCTTCACGCGAAGGCATACGCCGTGCAT|ACGCCGTGGCGAACGGACGATGTTACGCAT
GGTGTAGATGCTAAAAATCTGGGTAGTTAG|GTTTTGGAGGCCTCTCGTCCAATTTCACAA
CGATGGGACTTAGCGCCGAAAACTATCATG|CCCTAGGAGACGAGTCCCGACTGGCGTTAC
GAAACGTCATGTCTTCACGCGAAGGCATAC|CATTGCCAATATGGACGAAAAAAGTCACTT
TGGAGGCCTCTCGTCCAATTTCACAACCGG|TGCCTGTCATGTCTTCACGCGAAGGCATAC
GCGTATGACGGTGAACTTGCAAGGGGGGGC|CACTATTGGCACAAAGTTCCTTTTCGATGC
CGAAGGCATACGCCGTGGTGGTTTTGGAGG|AAAAGTCACTTATCAGTATGCGCGTGCCTG
GAAGGCATACGCCGTGTTGACCGGGTGCCC|AAACGCGTATGACGGTGAACTTGCAAGGGG
TAAAAATCTGGGTAGTTAGCTTTTAAGAAA|CTCTCGTCCAATTTCACAACCGGTGCCAAT
CTTAGTTTCGTTCGGGTGTAGATGCTAAAA|CATACGCCGTGGTGGTTTTGGAGGCCTCTC
CGCCGTGCGTGTGCTTTTATACCGCTTGAA|CGGTGCCATTGAGAGCGATCACACGGGGAT
CTAGAAGGCCTGTTCAAGCTGGCTTAGTAA|GCATACGCCGTGTTGACCGGGTGCCCTCTC
GCCCCCAGGCTAGGCGTGGACGCTCGTCCA|TGGTCCGGCTGCGTGGTCCATTCTAAATGC
CTTTTCGATGCCCCATCCCCTACTATCACA|TACTGGGACGCCTCAAGGATATGAGTATGA
TACGCATGAGCGATCAAGGGCCTATACGGT|GTGTCTTCACGCGAAGGCATACGCCGTGAT
ATTGACTCTAGTTCCTCATGTCTTCACGCG|GGACGATCGAGTCATGTCTTCACGCGAAGG
CCGCCGCAAGCTGGTGTTCAACACCACGCT|GCGAAGGCATACGCCGTGTCATGTCTTCAC
GTGTTCATACCTTACCGCGGAGTCCCTGTG|GTCATGTAAAATCCGAGTGTCAACGGTTAG
CTGTTCAAGCTGGCTTAGTAAAGTCCTAGC|GTGTTGACCGGGTGCCCTCTCATGTCTTCA
ATGAGCGATCAAGGGCCTATACGGTGCCAT|TTCACGCGAAGGCATACGCCGTGATTCGGT
TCTGGGTAGTTAGCTTTTAAGAAATTTGTA|TCCAATTTCACAACCGGTGCCAATTGACTC
AGCTTTTAAGAAATTTGTACCAATTTTCCC|AACCGGTGCCAATTGACTCTAGTTCCTCAT
AGCACCGCCGCAAGCTGGTGTTCAACACCA|TCACGCGAAGGCATACGCCGTGTCATGTCT
GGAGTCCCTGTGATGCCCGAGAGAAACGCG|GTCAACGGTTAGGCTCACCCCAGGACTCAC
AGATTAGGGTTGAAACGTCATGTCTTCACG|CGTGCACCGACCATTGCCAATATGGACGAA
TCACGCGAAGGCATACGCCGTGGACGATCG|CGTAGTATTTCTCATGTCTTCACGCGAAGG
TTCATACCTTACCGCGGAGTCCCTGTGATG|ATGTAAAATCCGAGTGTCAACGGTTAGGCT
TGCTAAAAATCTGGGTAGTTAGCTTTTAAG|GGCCTCTCGTCCAATTTCACAACCGGTGCC
TGGCGTTACTAGGTTATTCATGTCATGTCT|CTAGCACCGCCGCAAGCTGGTGTTCAACAC
TACTATCACAGGTGGTCCGGCTGCGTGGTC|ATGAGTATGAGGGTATAAGTAACAAGCCCG
AATCTGGGTAGTTAGCTTTTAAGAAATTTG|CGTCCAATTTCACAACCGGTGCCAATTGAC
TGTCTTCACGCGAAGGCATACGCCGTGCCG|CGCCGAAAACTATCATGTCTTCACGCGAAG
TTCACGCGAAGGCATACGCCGTGCGTGTGC|CGATCAAGGGCCTATACGGTGCCATTGAGA
AGGCATACGCCGTGTTCATACCTTACCGCG|TCGTCCACTCCGTCATGTAAAATCCGAGTG
ATCCTAGAAGGCCTGTTCAAGCTGGCTTAG|AAGGCATACGCCGTGTTGACCGGGTGCCCT
TCCGAGTGTCAACGGTTAGGCTCACCCCAG|CTGTGGGACCTGCTCCATGTGAACTAGGCA
CGCACAACGCGGGCTCGCCCGTAGTATTTC|CACGCGAAGGCATACGCCGTGCGTGTGCTT
CGCCGTGTCATGTCTTCACGCGAAGGCATA|GCCCCCAGGCTAGGCGTGGACGCTCGTCCA
TTCACGCGAAGGCATACGCCGTGCCTGGAT|ACGCCGTGTTCATACCTTACCGCGGAGTCC
ACGATCGAGTCATGTCTTCACGCGAAGGCA|GCGAAGGCATACGCCGTGATGTCTTCACGC
TGCCCGAGAGAAACGCGTATGACGGTGAAC|CTCACCCCAGGACTCACTATTGGCACAAAG
GGTGCCCTCTCATGTCTTCACGCGAAGGCA|CAAGGGGGGGCCTCACGTTGTCTGCCAGTA
CATCGATGGGACTTAGCGCCGAAAACTATC|AGTCCCTAGGAGACGAGTCCCGACTGGCGT
TAGTTAGCTTTTAAGAAATTTGTACCAATT|TTCACAACCGGTGCCAATTGACTCTAGTTC
ACGCGGGCTCGCCCGTAGTATTTCTCATGT|AAGGCATACGCCGTGCGTGTGCTTTTATAC
GCGTGTGCTTTTATACCGCTTGAACCATCG|CATTGAGAGCGATCACACGGGGATAAGTCC
CAAAGTTCCTTTTCGATGCCCCATCCCCTA|TATACTAATACTGGGACGCCTCAAGGATAT
ACGTTGTCTGCCAGTAGCGCCCCCAGGCTA|ATCCCCTACTATCACAGGTGGTCCGGCTGC
CCGCGGAGTCCCTGTGATGCCCGAGAGAAA|GAGTGTCAACGGTTAGGCTCACCCCAGGAC
AATTTCAAACTTAGTTTCGTTCGGGTGTAG|ACGCGAAGGCATACGCCGTGGTGGTTTTGG
GTGCCGTTCATGTCTTCACGCGAAGGCATA|GCGAAGGCATACGCCGTGGCGAACGGACGA
TGCGCGTGCCTGTCATGTCTTCACGCGAAG|TCGCACAACGCGGGCTCGCCCGTAGTATTT
ACGCGAAGGCATACGCCGTGCCTGGATTAT|CCGTGTTCATACCTTACCGCGGAGTCCCTG
TTTGGAGGCCTCTCGTCCAATTTCACAACC|CGTGCCTGTCATGTCTTCACGCGAAGGCAT
CATACGCCGTGCACCGACCATTGCCAATAT|CGCCGTGAGATTATAACCTTGTCACGTCCG
TCACGGTGATCCTAGAAGGCCTGTTCAAGC|TTCACGCGAAGGCATACGCCGTGTTGACCG
GGTGTTCAACACCACGCTGGCTCATGTCTT|GCCGTGTCATGTCTTCACGCGAAGGCATAC
ATCGATGGGACTTAGCGCCGAAAACTATCA|GTCCCTAGGAGACGAGTCCCGACTGGCGTT
TCACGCGAAGGCATACGCCGTGCATGTCTT|GTGGCGAACGGACGATGTTACGCATGAGCG
AGCGATCAAGGGCCTATACGGTGCCATTGA|ACGCGAAGGCATACGCCGTGATTCGGTCTC
GCCCTCTCATGTCTTCACGCGAAGGCATAC|GGGGGGGCCTCACGTTGTCTGCCAGTAGCG
GCCTGTCATGTCTTCACGCGAAGGCATACG|ACGCGGGCTCGCCCGTAGTATTTCTCATGT
TATAACCTTGTCACGTCCGGGAGCGTTATC|GTGCCGTTCATGTCTTCACGCGAAGGCATA
CGTGATGTCTTCACGCGAAGGCATACGCCG|CTTAGCGCCGAAAACTATCATGTCTTCACG
CGTGGTGGTTTTGGAGGCCTCTCGTCCAAT|CAGTATGCGCGTGCCTGTCATGTCTTCACG
GTTCCTTTTCGATGCCCCATCCCCTACTAT|CTAATACTGGGACGCCTCAAGGATATGAGT
CTTCACGCGAAGGCATACGCCGTGGACGAT|CCCGTAGTATTTCTCATGTCTTCACGCGAA
GGCCTTGCGCCCAAGATTAGGGTTGAAACG|CGAAGGCATACGCCGTGCACCGACCATTGC
CGTGTCTTCACGCGAAGGCATACGCCGTGA|CACGCGAAGGCATACGCCGTGCCTGGATTA
GACTGGCGTTACTAGGTTATTCATGTCATG|GTCCTAGCACCGCCGCAAGCTGGTGTTCAA
ATGGACGAAAAAAGTCACTTATCAGTATGC|CGGGAGCGTTATCCTAGGGCTTTGCTCTCG
ACGCCGTGCCTGGATTATCATGTCTTCACG|CTTACCGCGGAGTCCCTGTGATGCCCGAGA
AGTCATGTCTTCACGCGAAGGCATACGCCG|CATACGCCGTGATGTCTTCACGCGAAGGCA
CAATTTCACAACCGGTGCCAATTGACTCTA|CACGCGAAGGCATACGCCGTGGACGATCGA
TACGCCGTGTTCATACCTTACCGCGGAGTC|CACTCCGTCATGTAAAATCCGAGTGTCAAC
GCGAAGGCATACGCCGTGTCATGTCTTCAC|CTGCCAGTAGCGCCCCCAGGCTAGGCGTGG
GGCATACGCCGTGATGTCTTCACGCGAAGG|TCGATGGGACTTAGCGCCGAAAACTATCAT
CATGTCTTCACGCGAAGGCATACGCCGTGC|CATGAGCGATCAAGGGCCTATACGGTGCCA
CTATTGGCACAAAGTTCCTTTTCGATGCCC|GAAGGCTTGTATACTAATACTGGGACGCCT
TAGAAGGCCTGTTCAAGCTGGCTTAGTAAA|CATACGCCGTGTTGACCGGGTGCCCTCTCA
CGTTACTAGGTTATTCATGTCATGTCTTCA|GCACCGCCGCAAGCTGGTGTTCAACACCAC
CGTGAGATTATAACCTTGTCACGTCCGGGA|CATACGCCGTGCCGTTCATGTCTTCACGCG
GAAAACTATCATGTCTTCACGCGAAGGCAT|CGACTGGCGTTACTAGGTTATTCATGTCAT
TACGCCGTGGCGAACGGACGATGTTACGCA|TGTCTTCACGCGAAGGCATACGCCGTGTCT
TTGGCACAAAGTTCCTTTTCGATGCCCCAT|GGCTTGTATACTAATACTGGGACGCCTCAA
AATCCGAGTGTCAACGGTTAGGCTCACCCC|GCCTGTGGGACCTGCTCCATGTGAACTAGG
AACGCGTATGACGGTGAACTTGCAAGGGGG|ACTCACTATTGGCACAAAGTTCCTTTTCGA
GTCTTCACGCGAAGGCATACGCCGTGTTGA|TGCCCGAGAGAAACGCGTATGACGGTGAAC
CGTGTTCATACCTTACCGCGGAGTCCCTGT|CGTCATGTAAAATCCGAGTGTCAACGGTTA
CGCGAAGGCATACGCCGTGCATGTCTTCAC|GCGAACGGACGATGTTACGCATGAGCGATC
CATACGCCGTGATGTCTTCACGCGAAGGCA|GATGGGACTTAGCGCCGAAAACTATCATGT
AGGCTCACCCCAGGACTCACTATTGGCACA|TGTGAACTAGGCACTGCCTGAAGGCTTGTA
GCGTTATCCTAGGGCTTTGCTCTCGCACAA|AAGGCATACGCCGTGCATGTCTTCACGCGA
GAGTCCCTGTGATGCCCGAGAGAAACGCGT|TCAACGGTTAGGCTCACCCCAGGACTCACT
TTACTAGGTTATTCATGTCATGTCTTCACG|ACCGCCGCAAGCTGGTGTTCAACACCACGC
CACAAAGTTCCTTTTCGATGCCCCATCCCC|TGTATACTAATACTGGGACGCCTCAAGGAT
CAAATTTCAAACTTAGTTTCGTTCGGGTGT|TCACGCGAAGGCATACGCCGTGGTGGTTTT
GAGTGTCAACGGTTAGGCTCACCCCAGGAC|TGGGACCTGCTCCATGTGAACTAGGCACTG
GCGCGTGCCTGTCATGTCTTCACGCGAAGG|CGCACAACGCGGGCTCGCCCGTAGTATTTC
GGTTATTCATGTCATGTCTTCACGCGAAGG|GCAAGCTGGTGTTCAACACCACGCTGGCTC
AAGGCATACGCCGTGAGATTATAACCTTGT|TCACGCGAAGGCATACGCCGTGCCGTTCAT
ATTTCACAACCGGTGCCAATTGACTCTAGT|CGCGAAGGCATACGCCGTGGACGATCGAGT
ACGCGAAGGCATACGCCGTGCATGTCTTCA|GGCGAACGGACGATGTTACGCATGAGCGAT
TAGCGCCCCCAGGCTAGGCGTGGACGCTCG|CAGGTGGTCCGGCTGCGTGGTCCATTCTAA
AAGGCATACGCCGTGCACCGACCATTGCCA|CATACGCCGTGAGATTATAACCTTGTCACG
GCCGTTCATGTCTTCACGCGAAGGCATACG|GAAGGCATACGCCGTGGCGAACGGACGATG
GAGTCCCGACTGGCGTTACTAGGTTATTCA|TAGTAAAGTCCTAGCACCGCCGCAAGCTGG
TGGCCTTGCGCCCAAGATTAGGGTTGAAAC|GCGAAGGCATACGCCGTGCACCGACCATTG
CTTACCGCGGAGTCCCTGTGATGCCCGAGA|ATCCGAGTGTCAACGGTTAGGCTCACCCCA
TAAACTATTGGCCTTGCGCCCAAGATTAGG|GTCTTCACGCGAAGGCATACGCCGTGCACC
TATACGGTGCCATTGAGAGCGATCACACGG|GCCGTGATTCGGTCTCACGGTGATCCTAGA
GGCATACGCCGTGAGATTATAACCTTGTCA|ACGCGAAGGCATACGCCGTGCCGTTCATGT
GGCATACGCCGTGTTGACCGGGTGCCCTCT|CGCGTATGACGGTGAACTTGCAAGGGGGGG
ATGTCTTCACGCGAAGGCATACGCCGTGTC|CAACACCACGCTGGCTCATGTCTTCACGCG
CCCTGTGATGCCCGAGAGAAACGCGTATGA|CGGTTAGGCTCACCCCAGGACTCACTATTG
TTCACGCGAAGGCATACGCCGTGTCTTCAC|CCACGCTGGCTCATGTCTTCACGCGAAGGC
CTTATCAGTATGCGCGTGCCTGTCATGTCT|GGCTTTGCTCTCGCACAACGCGGGCTCGCC
CAACACCACGCTGGCTCATGTCTTCACGCG|TCATGTCTTCACGCGAAGGCATACGCCGTG
TCACAGGTGGTCCGGCTGCGTGGTCCATTC|TATGAGGGTATAAGTAACAAGCCCGGGAAA
ACCGGGTGCCCTCTCATGTCTTCACGCGAA|CTTGCAAGGGGGGGCCTCACGTTGTCTGCC
GCATACGCCGTGCGTGTGCTTTTATACCGC|CTATACGGTGCCATTGAGAGCGATCACACG
CGCCCGTAGTATTTCTCATGTCTTCACGCG|GCCGTGCGTGTGCTTTTATACCGCTTGAAC
CTTCACGCGAAGGCATACGCCGTGCATGTC|CCGTGGCGAACGGACGATGTTACGCATGAG
TTCATGTCATGTCTTCACGCGAAGGCATAC|CTGGTGTTCAACACCACGCTGGCTCATGTC
TCACGTTGTCTGCCAGTAGCGCCCCCAGGC|CCATCCCCTACTATCACAGGTGGTCCGGCT
TAGCGCCGAAAACTATCATGTCTTCACGCG|CGAGTCCCGACTGGCGTTACTAGGTTATTC
TCCCGACTGGCGTTACTAGGTTATTCATGT|TAAAGTCCTAGCACCGCCGCAAGCTGGTGT
TCTTCACGCGAAGGCATACGCCGTGCGTGT|AGCGATCAAGGGCCTATACGGTGCCATTGA
ACCGCCGCAAGCTGGTGTTCAACACCACGC|CGCGAAGGCATACGCCGTGTCATGTCTTCA
CGCGTGCCTGTCATGTCTTCACGCGAAGGC|GCACAACGCGGGCTCGCCCGTAGTATTTCT
CATACGCCGTGCATGTCTTCACGCGAAGGC|ACGATGTTACGCATGAGCGATCAAGGGCCT
TCTTCACGCGAAGGCATACGCCGTGCACCG|CACGCGAAGGCATACGCCGTGAGATTATAA
AGGCATACGCCGTGGTGGTTTTGGAGGCCT|AGTCACTTATCAGTATGCGCGTGCCTGTCA
CGGGGATAAGTCCCTAGGAGACGAGTCCCG|AGAAGGCCTGTTCAAGCTGGCTTAGTAAAG
CATACGCCGTGCCTGGATTATCATGTCTTC|TACCTTACCGCGGAGTCCCTGTGATGCCCG
TTTCCCTAAACTATTGGCCTTGCGCCCAAG|CCTCATGTCTTCACGCGAAGGCATACGCCG
AGTTTCGTTCGGGTGTAGATGCTAAAAATC|ACGCCGTGGTGGTTTTGGAGGCCTCTCGTC
CCCCCAGGCTAGGCGTGGACGCTCGTCCAC|GGTCCGGCTGCGTGGTCCATTCTAAATGCT
GCGAAGGCATACGCCGTGGTGGTTTTGGAG|AAAAAGTCACTTATCAGTATGCGCGTGCCT
GTTTCGTTCGGGTGTAGATGCTAAAAATCT|CGCCGTGGTGGTTTTGGAGGCCTCTCGTCC
ACGCGAAGGCATACGCCGTGGCGAACGGAC|TATTCATGTCATGTCTTCACGCGAAGGCAT
GATCAAGGGCCTATACGGTGCCATTGAGAG|CGAAGGCATACGCCGTGATTCGGTCTCACG
CTAGCACCGCCGCAAGCTGGTGTTCAACAC|CTTCACGCGAAGGCATACGCCGTGTCATGT
ATACGCCGTGATGTCTTCACGCGAAGGCAT|ATGGGACTTAGCGCCGAAAACTATCATGTC
TGTCTTCACGCGAAGGCATACGCCGTGCAC|TTCACGCGAAGGCATACGCCGTGAGATTAT
GGCTCGCCCGTAGTATTTCTCATGTCTTCA|ATACGCCGTGCGTGTGCTTTTATACCGCTT
TACGCCGTGCACCGACCATTGCCAATATGG|CCGTGAGATTATAACCTTGTCACGTCCGGG
TTTCGTTCGGGTGTAGATGCTAAAAATCTG|GCCGTGGTGGTTTTGGAGGCCTCTCGTCCA
CCTTTTCGATGCCCCATCCCCTACTATCAC|ATACTGGGACGCCTCAAGGATATGAGTATG
TGCCCCATCCCCTACTATCACAGGTGGTCC|CGCCTCAAGGATATGAGTATGAGGGTATAA
CAGGTGGTCCGGCTGCGTGGTCCATTCTAA|GAGGGTATAAGTAACAAGCCCGGGAAAACG
GGGGGCCTCACGTTGTCTGCCAGTAGCGCC|CGATGCCCCATCCCCTACTATCACAGGTGG
AGTAAAGTCCTAGCACCGCCGCAAGCTGGT|CTCTCATGTCTTCACGCGAAGGCATACGCC
GTCTTCACGCGAAGGCATACGCCGTGCCGT|GCCGAAAACTATCATGTCTTCACGCGAAGG
TATGACGGTGAACTTGCAAGGGGGGGCCTC|TATTGGCACAAAGTTCCTTTTCGATGCCCC
AAGTCCTAGCACCGCCGCAAGCTGGTGTTC|CATGTCTTCACGCGAAGGCATACGCCGTGT
TTCGGTCTCACGGTGATCCTAGAAGGCCTG|TCATGTCTTCACGCGAAGGCATACGCCGTG
ATACGCCGTGCCGTTCATGTCTTCACGCGA|TCTTCACGCGAAGGCATACGCCGTGGCGAA
AAGTCACTTATCAGTATGCGCGTGCCTGTC|TCCTAGGGCTTTGCTCTCGCACAACGCGGG
TCTTCACGCGAAGGCATACGCCGTGGACGA|GCCCGTAGTATTTCTCATGTCTTCACGCGA
TGACTCTAGTTCCTCATGTCTTCACGCGAA|ACGATCGAGTCATGTCTTCACGCGAAGGCA
GACGATCGAGTCATGTCTTCACGCGAAGGC|CGCGAAGGCATACGCCGTGATGTCTTCACG
AGGACTCACTATTGGCACAAAGTTCCTTTT|CACTGCCTGAAGGCTTGTATACTAATACTG
CTTAGTAAAGTCCTAGCACCGCCGCAAGCT|GCCCTCTCATGTCTTCACGCGAAGGCATAC
CGAAAACTATCATGTCTTCACGCGAAGGCA|CCGACTGGCGTTACTAGGTTATTCATGTCA
CGCGGGCTCGCCCGTAGTATTTCTCATGTC|AGGCATACGCCGTGCGTGTGCTTTTATACC
ATGGGACTTAGCGCCGAAAACTATCATGTC|CTAGGAGACGAGTCCCGACTGGCGTTACTA
ACACGGGGATAAGTCCCTAGGAGACGAGTC|CCTAGAAGGCCTGTTCAAGCTGGCTTAGTA
ACCGCGGAGTCCCTGTGATGCCCGAGAGAA|CGAGTGTCAACGGTTAGGCTCACCCCAGGA
GAAGGCATACGCCGTGAGATTATAACCTTG|TTCACGCGAAGGCATACGCCGTGCCGTTCA
GTCCTAGCACCGCCGCAAGCTGGTGTTCAA|TGTCTTCACGCGAAGGCATACGCCGTGTCA
TACGCCGTGTCATGTCTTCACGCGAAGGCA|GCGCCCCCAGGCTAGGCGTGGACGCTCGTC
CGTCATGTAAAATCCGAGTGTCAACGGTTA|CCGCTAGACTGCCTGTGGGACCTGCTCCAT
CTAGGTTATTCATGTCATGTCTTCACGCGA|GCCGCAAGCTGGTGTTCAACACCACGCTGG
GGCCTATACGGTGCCATTGAGAGCGATCAC|ATACGCCGTGATTCGGTCTCACGGTGATCC
CTCACGGTGATCCTAGAAGGCCTGTTCAAG|CTTCACGCGAAGGCATACGCCGTGTTGACC
TACTAGGTTATTCATGTCATGTCTTCACGC|CCGCCGCAAGCTGGTGTTCAACACCACGCT
GCCGTGCGTGTGCTTTTATACCGCTTGAAC|GGTGCCATTGAGAGCGATCACACGGGGATA
TTGAAACGTCATGTCTTCACGCGAAGGCAT|ACCATTGCCAATATGGACGAAAAAAGTCAC
AACCATCGATGGGACTTAGCGCCGAAAACT|ATAAGTCCCTAGGAGACGAGTCCCGACTGG
ACGTCATGTCTTCACGCGAAGGCATACGCC|TGCCAATATGGACGAAAAAAGTCACTTATC
GATTATCATGTCTTCACGCGAAGGCATACG|TCCCTGTGATGCCCGAGAGAAACGCGTATG
CATGTCTTCACGCGAAGGCATACGCCGTGG|AATATGGACGAAAAAAGTCACTTATCAGTA
GTGTTGACCGGGTGCCCTCTCATGTCTTCA|GGTGAACTTGCAAGGGGGGGCCTCACGTTG
TCCCCTACTATCACAGGTGGTCCGGCTGCG|AGGATATGAGTATGAGGGTATAAGTAACAA
CATGTCTTCACGCGAAGGCATACGCCGTGT|GCTAGGCGTGGACGCTCGTCCACTCCGTCA
TTTTGGAGGCCTCTCGTCCAATTTCACAAC|GCGTGCCTGTCATGTCTTCACGCGAAGGCA
ACTTATCAGTATGCGCGTGCCTGTCATGTC|GGGCTTTGCTCTCGCACAACGCGGGCTCGC
CCATTGCCAATATGGACGAAAAAAGTCACT|CTTGTCACGTCCGGGAGCGTTATCCTAGGG
AGGCATACGCCGTGATGTCTTCACGCGAAG|ATCGATGGGACTTAGCGCCGAAAACTATCA
TCATGTCTTCACGCGAAGGCATACGCCGTG|AAGGCATACGCCGTGTTCATACCTTACCGC
TGTCATGTCTTCACGCGAAGGCATACGCCG|CGGGCTCGCCCGTAGTATTTCTCATGTCTT
GGTGATCCTAGAAGGCCTGTTCAAGCTGGC|CGCGAAGGCATACGCCGTGTTGACCGGGTG
TACGCCGTGATTCGGTCTCACGGTGATCCT|GCCTGGATTATCATGTCTTCACGCGAAGGC
GCTCATGTCTTCACGCGAAGGCATACGCCG|CGAAGGCATACGCCGTGTTCATACCTTACC
CGAGTCCCGACTGGCGTTACTAGGTTATTC|TTAGTAAAGTCCTAGCACCGCCGCAAGCTG
GATTCGGTCTCACGGTGATCCTAGAAGGCC|TATCATGTCTTCACGCGAAGGCATACGCCG
AAGCTGGTGTTCAACACCACGCTGGCTCAT|CATACGCCGTGTCATGTCTTCACGCGAAGG
TCATGTCTTCACGCGAAGGCATACGCCGTG|GGCTCGCCCGTAGTATTTCTCATGTCTTCA
TAGTTCCTCATGTCTTCACGCGAAGGCATA|GAGTCATGTCTTCACGCGAAGGCATACGCC
ATACGCCGTGCGTGTGCTTTTATACCGCTT|ATACGGTGCCATTGAGAGCGATCACACGGG
ACGCCGTGAGATTATAACCTTGTCACGTCC|AAGGCATACGCCGTGCCGTTCATGTCTTCA
AAGGCATACGCCGTGATTCGGTCTCACGGT|CGCCGTGCCTGGATTATCATGTCTTCACGC
GCGAAGGCATACGCCGTGTTCATACCTTAC|ACGCTCGTCCACTCCGTCATGTAAAATCCG
TGTCATGTCTTCACGCGAAGGCATACGCCG|CAGGCTAGGCGTGGACGCTCGTCCACTCCG
CGTATGACGGTGAACTTGCAAGGGGGGGCC|ACTATTGGCACAAAGTTCCTTTTCGATGCC
AAAATCTGGGTAGTTAGCTTTTAAGAAATT|CTCGTCCAATTTCACAACCGGTGCCAATTG
TGTCACGTCCGGGAGCGTTATCCTAGGGCT|CATGTCTTCACGCGAAGGCATACGCCGTGC
ACTCACAAATTTCAAACTTAGTTTCGTTCG|TGTCTTCACGCGAAGGCATACGCCGTGGTG
TATCAGTATGCGCGTGCCTGTCATGTCTTC|CTTTGCTCTCGCACAACGCGGGCTCGCCCG
GACTCTAGTTCCTCATGTCTTCACGCGAAG|CGATCGAGTCATGTCTTCACGCGAAGGCAT
CACGCGAAGGCATACGCCGTGTCATGTCTT|TGTCTGCCAGTAGCGCCCCCAGGCTAGGCG
AACGGTTAGGCTCACCCCAGGACTCACTAT|TGCTCCATGTGAACTAGGCACTGCCTGAAG
CCGTGAGATTATAACCTTGTCACGTCCGGG|GCATACGCCGTGCCGTTCATGTCTTCACGC
GCGAAGGCATACGCCGTGCCTGGATTATCA|GTGTTCATACCTTACCGCGGAGTCCCTGTG
GTTGACCGGGTGCCCTCTCATGTCTTCACG|TGAACTTGCAAGGGGGGGCCTCACGTTGTC
CTGGATTATCATGTCTTCACGCGAAGGCAT|GAGTCCCTGTGATGCCCGAGAGAAACGCGT
GTCTTCACGCGAAGGCATACGCCGTGGCGA|CTAGGTTATTCATGTCATGTCTTCACGCGA
TAGTATTTCTCATGTCTTCACGCGAAGGCA|CGTGTGCTTTTATACCGCTTGAACCATCGA
CGCGAAGGCATACGCCGTGTTCATACCTTA|GACGCTCGTCCACTCCGTCATGTAAAATCC
CCGACTGGCGTTACTAGGTTATTCATGTCA|AAGTCCTAGCACCGCCGCAAGCTGGTGTTC
CACAACGCGGGCTCGCCCGTAGTATTTCTC|CGCGAAGGCATACGCCGTGCGTGTGCTTTT
TAAACTCACAAATTTCAAACTTAGTTTCGT|TCATGTCTTCACGCGAAGGCATACGCCGTG
ACGCGAAGGCATACGCCGTGAGATTATAAC|TGTCTTCACGCGAAGGCATACGCCGTGCCG
GGTGAACTTGCAAGGGGGGGCCTCACGTTG|CACAAAGTTCCTTTTCGATGCCCCATCCCC
AGGAGACGAGTCCCGACTGGCGTTACTAGG|GCTGGCTTAGTAAAGTCCTAGCACCGCCGC
AGGCATACGCCGTGTCATGTCTTCACGCGA|CAGTAGCGCCCCCAGGCTAGGCGTGGACGC
ATACGCCGTGCACCGACCATTGCCAATATG|GCCGTGAGATTATAACCTTGTCACGTCCGG
AAGGCATACGCCGTGCCTGGATTATCATGT|TTCATACCTTACCGCGGAGTCCCTGTGATG
GTGCCAATTGACTCTAGTTCCTCATGTCTT|CGCCGTGGACGATCGAGTCATGTCTTCACG
AGTATTTCTCATGTCTTCACGCGAAGGCAT|GTGTGCTTTTATACCGCTTGAACCATCGAT
TAGGGCTTTGCTCTCGCACAACGCGGGCTC|GCCGTGCATGTCTTCACGCGAAGGCATACG
AAATCTGGGTAGTTAGCTTTTAAGAAATTT|TCGTCCAATTTCACAACCGGTGCCAATTGA
CCTGGATTATCATGTCTTCACGCGAAGGCA|GGAGTCCCTGTGATGCCCGAGAGAAACGCG
TCGCACAACGCGGGCTCGCCCGTAGTATTT|TCACGCGAAGGCATACGCCGTGCGTGTGCT
AACTCACAAATTTCAAACTTAGTTTCGTTC|ATGTCTTCACGCGAAGGCATACGCCGTGGT
TCTTCACGCGAAGGCATACGCCGTGGTGGT|TGGACGAAAAAAGTCACTTATCAGTATGCG
AGGCGTGGACGCTCGTCCACTCCGTCATGT|CGTGGTCCATTCTAAATGCTATCCGCTAGA
GGTGCCATTGAGAGCGATCACACGGGGATA|GATTCGGTCTCACGGTGATCCTAGAAGGCC
CCTAAACTATTGGCCTTGCGCCCAAGATTA|ATGTCTTCACGCGAAGGCATACGCCGTGCA
GGCATACGCCGTGGTGGTTTTGGAGGCCTC|GTCACTTATCAGTATGCGCGTGCCTGTCAT
CATACGCCGTGGACGATCGAGTCATGTCTT|TCATGTCTTCACGCGAAGGCATACGCCGTG
CCCAAGATTAGGGTTGAAACGTCATGTCTT|ACGCCGTGCACCGACCATTGCCAATATGGA
GTAGTTAGCTTTTAAGAAATTTGTACCAAT|TTTCACAACCGGTGCCAATTGACTCTAGTT
GGGCCTCACGTTGTCTGCCAGTAGCGCCCC|ATGCCCCATCCCCTACTATCACAGGTGGTC
AAGGCATACGCCGTGGACGATCGAGTCATG|TTTCTCATGTCTTCACGCGAAGGCATACGC
TCTTCACGCGAAGGCATACGCCGTGATTCG|CGAAGGCATACGCCGTGCCTGGATTATCAT
GGCTTTGCTCTCGCACAACGCGGGCTCGCC|GTGCATGTCTTCACGCGAAGGCATACGCCG
CTTCACGCGAAGGCATACGCCGTGGTGGTT|GGACGAAAAAAGTCACTTATCAGTATGCGC
AGAAACGCGTATGACGGTGAACTTGCAAGG|AGGACTCACTATTGGCACAAAGTTCCTTTT
GCATACGCCGTGCCGTTCATGTCTTCACGC|TGTCTTCACGCGAAGGCATACGCCGTGGCG
CGAAGGCATACGCCGTGAGATTATAACCTT|CTTCACGCGAAGGCATACGCCGTGCCGTTC
CGTCCGGGAGCGTTATCCTAGGGCTTTGCT|CTTCACGCGAAGGCATACGCCGTGCATGTC
AAAAAAGTCACTTATCAGTATGCGCGTGCC|GTTATCCTAGGGCTTTGCTCTCGCACAACG
GCTTTGCTCTCGCACAACGCGGGCTCGCCC|TGCATGTCTTCACGCGAAGGCATACGCCGT
CGAAGGCATACGCCGTGATTCGGTCTCACG|TACGCCGTGCCTGGATTATCATGTCTTCAC
AAACGTCATGTCTTCACGCGAAGGCATACG|ATTGCCAATATGGACGAAAAAAGTCACTTA
ACGCGAAGGCATACGCCGTGCCGTTCATGT|AACTATCATGTCTTCACGCGAAGGCATACG
TTGGCCTTGCGCCCAAGATTAGGGTTGAAA|CGCGAAGGCATACGCCGTGCACCGACCATT
CATGTCTTCACGCGAAGGCATACGCCGTGG|GCTCGCCCGTAGTATTTCTCATGTCTTCAC
GTCTTCACGCGAAGGCATACGCCGTGTCAT|CACGTTGTCTGCCAGTAGCGCCCCCAGGCT
AGTATGCGCGTGCCTGTCATGTCTTCACGC|GCTCTCGCACAACGCGGGCTCGCCCGTAGT
TCGGTCTCACGGTGATCCTAGAAGGCCTGT|CATGTCTTCACGCGAAGGCATACGCCGTGT
CAAGGGGGGGCCTCACGTTGTCTGCCAGTA|CTTTTCGATGCCCCATCCCCTACTATCACA
TACGCCGTGCGTGTGCTTTTATACCGCTTG|TACGGTGCCATTGAGAGCGATCACACGGGG
TCTTCACGCGAAGGCATACGCCGTGCCTGG|ATACGCCGTGTTCATACCTTACCGCGGAGT
AAGGCATACGCCGTGTTGACCGGGTGCCCT|AACGCGTATGACGGTGAACTTGCAAGGGGG
CCCGACTGGCGTTACTAGGTTATTCATGTC|AAAGTCCTAGCACCGCCGCAAGCTGGTGTT
TTTGTACCAATTTTCCCTAAACTATTGGCC|TGACTCTAGTTCCTCATGTCTTCACGCGAA
ACGCCGTGATTCGGTCTCACGGTGATCCTA|CCTGGATTATCATGTCTTCACGCGAAGGCA
GGGGATAAGTCCCTAGGAGACGAGTCCCGA|GAAGGCCTGTTCAAGCTGGCTTAGTAAAGT
TCATACCTTACCGCGGAGTCCCTGTGATGC|TGTAAAATCCGAGTGTCAACGGTTAGGCTC
AAGGCATACGCCGTGCATGTCTTCACGCGA|ACGGACGATGTTACGCATGAGCGATCAAGG
TCCACTCCGTCATGTAAAATCCGAGTGTCA|ATGCTATCCGCTAGACTGCCTGTGGGACCT
GCTTGAACCATCGATGGGACTTAGCGCCGA|CGGGGATAAGTCCCTAGGAGACGAGTCCCG
TCATGTCTTCACGCGAAGGCATACGCCGTG|GTTACTAGGTTATTCATGTCATGTCTTCAC
TCTTCACGCGAAGGCATACGCCGTGGCGAA|TAGGTTATTCATGTCATGTCTTCACGCGAA
GTCATGTCTTCACGCGAAGGCATACGCCGT|ATACGCCGTGATGTCTTCACGCGAAGGCAT
TGATCCTAGAAGGCCTGTTCAAGCTGGCTT|CGAAGGCATACGCCGTGTTGACCGGGTGCC
CATGTCTTCACGCGAAGGCATACGCCGTGT|CCTCACGTTGTCTGCCAGTAGCGCCCCCAG
TTCACGCGAAGGCATACGCCGTGGTGGTTT|GACGAAAAAAGTCACTTATCAGTATGCGCG
TACGCCGTGCCGTTCATGTCTTCACGCGAA|CTTCACGCGAAGGCATACGCCGTGGCGAAC
ATTCATGTCATGTCTTCACGCGAAGGCATA|GCTGGTGTTCAACACCACGCTGGCTCATGT
ATCATGTCTTCACGCGAAGGCATACGCCGT|TGTGATGCCCGAGAGAAACGCGTATGACGG
CCCTAGGAGACGAGTCCCGACTGGCGTTAC|TCAAGCTGGCTTAGTAAAGTCCTAGCACCG
ACTATCATGTCTTCACGCGAAGGCATACGC|TGGCGTTACTAGGTTATTCATGTCATGTCT
CCTAGGAGACGAGTCCCGACTGGCGTTACT|CAAGCTGGCTTAGTAAAGTCCTAGCACCGC
TACGGTGCCATTGAGAGCGATCACACGGGG|CGTGATTCGGTCTCACGGTGATCCTAGAAG
ATGTCTTCACGCGAAGGCATACGCCGTGGC|TACTAGGTTATTCATGTCATGTCTTCACGC
CGTGCCTGGATTATCATGTCTTCACGCGAA|CCGCGGAGTCCCTGTGATGCCCGAGAGAAA
AGATTATAACCTTGTCACGTCCGGGAGCGT|CGCCGTGCCGTTCATGTCTTCACGCGAAGG
